oficiel avec le sac de alligateur.<n>And coming down the corridor are Oliver South and his black-suited men,<n>briefcases at the ready.<n>	#fiction#	fiction_TheStory.txt
the evil spirit to say his name.<n>"I am the devil in the details," is heard coming from the blue lips of<n>the baby.<n>	#fiction#	fiction_TheStory.txt
continue to exist? Would not a man rather have so much sympathy with<n>the coming generation as to spare it the borden of existence?"<n>from "On the Sufferings of the World," in Complete<n>	#fiction#	fiction_TheStory.txt
Nursing Reverend Mud-ju-ko-vis<n>Prophet of the coming Deluge.<n>Mud-ju in his acid springtime<n>	#fiction#	fiction_TheStory.txt
from the cliffs over Lake Superior, vaguely persuaded that something<n>special was coming his way. "The Wells Fargo Wagon" always had a<n>special poignancy for him, as did the underwear ads-no, any ads for<n>	#fiction#	fiction_TheStory.txt
the thin smoke. He doesn't have much time today, as his friend Mary (a<n>model for MonaLisa of the Desert) is coming down from the central<n>coast and Walt, another friend, may join them for dinner. "Walt's<n>	#fiction#	fiction_TheStory.txt
"What the fuck are you doing?" demanded Oedipa. "Let me out of here!"<n>"The Killers are coming for you, and me too now that I'm running with<n>you. We'll ditch this car at The Big Two-Hearted River. We'll go into<n>	#fiction#	fiction_TheStory.txt
Chapter 49 Nick, Atala and Rene, Ambrose and ?<n>"The Killers are coming for you, and me too now that I'm running with<n>you, Ambrose told Oedipa. "We'll ditch this car at The Big Two-Hearted<n>	#fiction#	fiction_TheStory.txt
that "Hick" is a sympathetic character--and in many ways a sad one. Cook is<n>entirely hip to the irony of their relationship: Just as Eleanor was coming to<n>the full command of her own powers, poor Hick (who quit the AP over the<n>	#journal#	journal_Article247_3286.txt
waged--showing up in public with Mary McLeod Bethune and Walter White, turning<n>the White House into a place where black people were routinely seen coming in<n>and going out the front door--may have been the most effective way to strike<n>	#journal#	journal_Article247_3299.txt
likelihood of presidential veto (certain). The papers agree that the GOP is<n>using the bills mostly to define issues for the coming elections.<n>Linda Tripp faces two felony counts for taping her conversations with Monica<n>	#journal#	journal_Article247_3309.txt
charges that he committed espionage at the Los Alamos nuclear facility. The<n>Justice Department will decide in the coming weeks if and on what counts to<n>prosecute Lee. His lawyers tell the DOJ that when Lee transferred classified<n>	#journal#	journal_Article247_3310.txt
Why? Partly for the same sorts of reasons that any new business must spend<n>money before it starts coming in--hiring employees, stocking up on yellow<n>notepads, throwing a launch party, etc.--but mainly because of the cost of<n>	#journal#	journal_Article247_3340.txt
the f-word on the record with a reporter.<n>The NYT and USAT report that the Navy is coming close to<n>resuming its former formal relationship with the Tailhook Association. By way<n>	#journal#	journal_Article247_3379.txt
selective silence should be: 1) Yes, Bush probably used cocaine sometime in his<n>life; and 2) who cares? Yet the question keeps coming up--increasingly, swathed<n>in dispassionate meta-analysis by reporters and political analysts. Today's<n>	#journal#	journal_Article247_3385.txt
marbles--his microphone was cut off when he didn't stop at the end of his<n>allotted ten minutes. "We are coming to the end of the most disgraceful and<n>immoral presidency in the history of this country."<n>	#journal#	journal_Article247_3408.txt
John McCain, who dismissed the event as a "sham," will concentrate instead on<n>California and New Hampshire in coming weeks, the NYT reports in its<n>"Political Briefing" column.<n>	#journal#	journal_Article247_3410.txt
means that it's hard to see how economic growth is going to be sustained there,<n>investors are wagering that the Japanese economy is coming back. Or it could<n>mean that ... Actually, the whole thing is probably just a conspiracy. Just<n>	#journal#	journal_Article247_3454.txt
spawned winds as high as 140 mph but was itself rather slow, heading north and<n>then northwest across the Gulf of Mexico at 7 mph before coming ashore about 6<n>p.m. local time in Kenedy County, population 420.<n>	#journal#	journal_Article247_3462.txt
people like me every day. The venues are many--from massive news coverage of<n>the coming out of a television star named Ellen (I loved the "Yep, I'm Gay"<n>title in Time magazine--it was more like "Of course, she's a big homo,"<n>	#journal#	journal_Article247_3465.txt
Grave: His Thoughts on Clinton's Impeachment, The War in Kosovo, and the Harry<n>Potter Craze , coming from Random House this fall.)<n>On August 9--the 25th anniversary of Richard Nixon's presidential<n>	#journal#	journal_Article247_3470.txt
'70s, when (as you point out) Star Wars had its astonishing apotheosis.<n>Is it coming back like platform shoes? Or maybe the explanation is Rowling's<n>quick, enchanted pen--she's turned out three Potter stories in two years,<n>	#journal#	journal_Article247_3477.txt
wireless means, we are all going to be plugged in more than ever before in the<n>coming years. I myself am a cell phone freak, who cannot imagine being without<n>my little Nokia 6160. Relying on cell phones completely, I had even abandoned<n>	#journal#	journal_Article247_3487.txt
business dynamics. Where we do differ, clearly, is our level of enthusiasm for<n>the coming of interactivity. You're right: I roll my eyes at the thought of an<n>"Internet refrigerator." I'm not all that sure I'd even want to have a Web site<n>	#journal#	journal_Article247_3489.txt
It's hard to feel sorry for either the bondholders or the stockholders,<n>since this was a train wreck you could have seen coming a mile away. (Click<n>here for<n>	#journal#	journal_Article247_3492.txt
were fired, apparently to no effect, hours before the fire began. The WP<n>explains why all this is coming to light now: further investigation by a<n>documentary filmmaker and attorneys for siege victims. The filmmaker also<n>	#journal#	journal_Article247_3494.txt
If she was such a compromised<n>character, why get upset about Lahti's not being asked back for the coming<n>season? After all, Barbara Hershey and Lauren Holly, hired more or less to<n>	#journal#	journal_Article247_3496.txt
The smarter mouse stories are occasioned by a write-up of the<n>research coming out in Nature today. In the experiment, extra copies of<n>a gene associated with recognizing something or remembering where something is<n>	#journal#	journal_Article247_3523.txt
to country and western stars and will soon own a $15 million, 18-acre office<n>and training-field complex that it will rent to the new NFL franchise coming to<n>town. And USA<n>	#journal#	journal_Article247_353.txt
overlooked by the new "tourist chic" elite. I love that the drive for<n>tourist-free fun is coming full circle, pushing hipsters back on the beaten<n>path. In these retro-crazed times, even the loathed Ugly American is getting<n>	#journal#	journal_Article247_3568.txt
rely on complimentary dinners and stays, which means that they notify the<n>establishment ahead of time that they're coming to write a review. Can you<n>imagine the succulent steak, the impeccable service, the free pair of Air<n>	#journal#	journal_Article247_3571.txt
be plentiful; the streets to be safe.<n>As for George Bush coming to shake hands at Unity in Seattle, perhaps it was<n>"a throwaway" as you say-but no more so (and quite probably less so)<n>	#journal#	journal_Article247_3573.txt
Republicans as a way to continue spending while technically not violating<n>Congress' previously agreed-upon spending caps: declare the coming fiscal year<n>to be made up of 13 months ("instead of the usual 12," explains the Post<n>	#journal#	journal_Article247_3608.txt
in the new issue! (Kausfiles came up with four, which seems low. Note to<n>Mickey: Johnny Depp hasn't got a Miramax movie coming out right at this very<n>moment, but with those tattoos and all, he's got a Miramax feel to him.<n>	#journal#	journal_Article247_3626.txt
and USA<n>Today lead with the coming ashore of Hurricane Floyd, which is moving<n>over land northward from Florida. The Los Angeles<n>	#journal#	journal_Article247_3629.txt
come from Hong Kong. "It's hard for me to accept that you didn't know this<n>money was coming from Hong Kong," committee member Sen. Joseph Lieberman is<n>quoted as saying. "My God, you went to Hong Kong to see Mr. Young."<n>	#journal#	journal_Article247_363.txt
The difference between Mary Richards and these two, of course, is that she<n>was striking out on her own, and they, having done so, are coming home. Is this<n>TV's blow against feminism? If we see the shows in a Mary Tyler Moore-era<n>	#journal#	journal_Article247_3648.txt
made and that an actual deal could be struck between the President, the House<n>and the Senate as early as today, with final passage coming by Friday.<n>And the broad shape of the likely deal is widely described. The LAT<n>	#journal#	journal_Article247_365.txt
ever had on its own.<n>The mayor, on the other hand, is coming off as a coward and a traitor. He's<n>too chicken to pick on a more established cultural institution such as MoMA,<n>	#journal#	journal_Article247_3671.txt
and the DUMBO section of Brooklyn.<n>It's no surprise that Giuliani is coming out as a cultural conservative. But<n>selling out his own city to do so is pretty sick stuff indeed.<n>	#journal#	journal_Article247_3671.txt
Nasdaq and the NYSE. The LAT quotes a stock<n>analyst's observation that Ballmer's timing was bizarre, coming the same day<n>that Microsoft announced plans to sell shares of its Expedia site as a way to<n>	#journal#	journal_Article247_3673.txt
network-wannabe that became a network last year on the basis of its hit teen<n>shows, will be forced to face more and more in coming years: Adolescents grow<n>up fast. This gives network executives three choices: 1) They can keep coming<n>	#journal#	journal_Article247_3688.txt
shows, will be forced to face more and more in coming years: Adolescents grow<n>up fast. This gives network executives three choices: 1) They can keep coming<n>up with new shows but risk losing the audiences from the last ones; 2) They can<n>	#journal#	journal_Article247_3688.txt
and the Los Angeles Times . The Washington Post gives the entire top of its front page to<n>sweeping changes in the D.C. governance system coming with the new budget bill,<n>(which was uneventfully passed yesterday by the House). Its coverage includes<n>	#journal#	journal_Article247_368.txt
tolerates left-wing universities because they serve as finishing schools for<n>the new ruling class. They give the coming elite an egalitarian sensibility, so<n>when they rise to the top, they won't give off offensive vapors that might<n>	#journal#	journal_Article247_3696.txt
Albert's face under the green lamp, and Albert's first stag at Balmoral, and<n>Albert in his blue and silver uniform, and the Baron coming in through a<n>doorway, and Lord M. dreaming at Windsor with the rooks cawing in the<n>	#journal#	journal_Article247_3699.txt
Office of Thrift Supervision's decision to budget $50,000 in government funds<n>so that OTS employees can in the coming months celebrate the office's tenth<n>anniversary at various outings, including a jazz brunch cruise down the<n>	#journal#	journal_Article247_3727.txt
Kasich told Clinton lobbyist John Hilley that, "...if we don't get a deal by<n>the beginning of the recess, I'm [expletive] coming over and burning your house<n>down!"<n>	#journal#	journal_Article247_372.txt
Giuliani and the Brooklyn Museum has only marginally penetrated here in Los<n>Angeles. We have the police department coming unglued with accusation of drug<n>dealing and death-squad tactics, and Mayor Riordan is in hiding as usual. But,<n>	#journal#	journal_Article247_3740.txt
opportunity! Readers, beware! MCI was mean to me! Me, me, me, me, me! I find it<n>hard to discharge my punditry duties in this space without coming across as<n>unbecomingly stuck on myself. You have been managing this very gracefully, I<n>	#journal#	journal_Article247_3759.txt
shift in bias.) So instead it was a week in which the stock market demonstrated<n>its continued resiliency, coming back strong after Tuesday's mild sell-off, and<n>in which the prospect of buoyant third-quarter earnings (which are all going to<n>	#journal#	journal_Article247_3782.txt
ideology, and of course oodles of history. There's a chance Americans will be<n>sending troops out to Central Asia in coming years to defend American oil<n>interests, so we should all be reading up on this stuff. And Kinzer is an<n>	#journal#	journal_Article247_3793.txt
banned by law--and all of their readers over 8 should be deported to post-coup<n>Pakistan for service in the coming war against India.<n>So who do you hate in cartooning? Love?<n>	#journal#	journal_Article247_3814.txt
Times : "Now, he says, he is trying to 'let it all hang out.' The very<n>phrase sounds unnatural coming from a man whose shoes are always polished,<n>whose hair is always combed, whose shirts and suits are always crisply pressed.<n>	#journal#	journal_Article247_3831.txt
"Meet the Press" that is repeated in both the WP and LAT : "A lot<n>of.business has gone away and a lot of business isn't coming back." The strike<n>has made many aware for the first time just how central UPS has been to the<n>	#journal#	journal_Article247_383.txt
the Senate's defeat of the comprehensive nuclear test ban treaty. His key<n>claim: Nuclear arms are coming into the hands of more and more countries not<n>because of the absence of such a treaty but because of the Clinton<n>	#journal#	journal_Article247_3840.txt
reduction in payroll (21,000 jobs), and $9.48 billion in cost cuts over the<n>next three years. The good news: the Z car is coming back. The NYT and<n>WP carry the story inside.<n>	#journal#	journal_Article247_3846.txt
Or what, if anything, in the book isn't fictional. Anyone with a nose for cooked quotes should be able<n>to detect the distinct odor of journalistic jambalaya coming from Hatfield's<n>book. All three of his arrest-story "sources" speak in a stilted,<n>	#journal#	journal_Article247_3850.txt
quiet efforts to warn local police about the possibility that anti-government<n>militias and hate groups will become increasingly dangerous in the coming year<n>because of the apocalyptic significance some of them attribute to the new<n>	#journal#	journal_Article247_3854.txt
downsides, inevitably. There was a complaint voiced in the New York<n>Times when typewriters were coming into favor in offices that the<n>typewriter depersonalized the written word, since the reader seemed further<n>	#journal#	journal_Article247_3864.txt
more consistent impetus to consumer spending than rising stock prices. The<n>broadcast version of Greenspan's speech looked like it was coming off the Web,<n>giving him the disconcerting appearance of the leader of a strange cult sitting<n>	#journal#	journal_Article247_3957.txt
tries to rise above the vulgus by giving its lead space to a piece about the<n>coming session of Congress. Mistake! First of all, the Congress piece is<n>virtually news-free: it's conjecture, after all, about what may happen there<n>	#journal#	journal_Article247_395.txt
state is undergoing a high-profile tightening of educational standards. In<n>coming years, statewide tests (with class work and attendance) will determine<n>which students advance to the next grade. All the papers report that a sharply<n>	#journal#	journal_Article247_3961.txt
thing about Michael Lind's book is what has not occurred. When I heard that it<n>was coming out, and what its title was, I thought: Oh, no, here we go again. I<n>was remembering the rancor that followed two previous revisionist works on<n>	#journal#	journal_Article247_3970.txt
the sense that Magnet thinks the black-white economic gap is purely a "cultural<n>matter," the result of "bad messages coming from the larger culture [read:<n>those privileged, white hippies!] that have encouraged a weak family<n>	#journal#	journal_Article247_3976.txt
mostly remembers is everyone marveling at or fretting about or otherwise<n>thinking of the momentous significance of the coming year. But a friend reminds<n>Chatterbox that a few things did happen in 1999. We fought an air war in<n>	#journal#	journal_Article247_3979.txt
The LAT reports that a growing number of members of Congress are<n>coming to the view that the proposed $368.5 billion tobacco settlement is too<n>big and too complicated to be enacted by Congress this year. Nobody's saying so<n>	#journal#	journal_Article247_397.txt
companies. The only company that's going to buy a Glaxo is another drug<n>company. So, there isn't any flood of outside capital coming into the drug<n>industry. If a wave of mergers gets touched off, all that's going to happen is<n>	#journal#	journal_Article247_3985.txt
cocaine production in Colombia alone could triple. Where is all that cocaine<n>going? Some officials think it's going to Europe; others think it's coming here<n>and that Americans are using more cocaine than previously feared. Not everyone<n>	#journal#	journal_Article247_3993.txt
human-rights issue as so negligible that such questions didn't even need to be<n>answered. (Presumably they will in the coming days, as editors scramble for<n>fresh angles.) As Human Rights Watch observed in a statement last month to the<n>	#journal#	journal_Article247_4008.txt
awake for it (of course) but on a Denver local newscast when I was visiting my<n>mom. They kept saying, "And coming up, Ricky Martin mania!" or whatever, like<n>it was a news item, and I'm sitting there thinking "ah, the sad state of<n>	#journal#	journal_Article247_4020.txt
Times and the national edition of the New York Times<n>(the metro edition of the NYT leads with the coming NYC Democratic<n>mayoral run-off). At the Washington Post , it's tobacco politics that leads and at<n>	#journal#	journal_Article247_403.txt
understanding of how they do things in the United Kingdom, is baffled by the<n>commentary coming out of Britain concerning the future of the House of Lords. As was widely publicized, the<n>Labor government earlier this month evicted 666 very Monty Python-ish<n>	#journal#	journal_Article247_4045.txt
of a candidate announcing with spouse and offspring in tow. And there is no<n>speculation in the leads about whether the coming physical distance between the<n>two Clintons represents a psychical one as well. (An NYT inside story, does briefly indulge, however.) This silence, which<n>	#journal#	journal_Article247_4054.txt
perfectly good piece of journalism is not so great a sin as preventing that<n>piece of journalism from coming to light in the first place. But the question<n>of why Disney's movie eliminated Bogdanich from its narrative remains an<n>	#journal#	journal_Article247_4055.txt
by Afrocentrists who take a somewhat different view of the long-term meaning of<n>"the coming of the white man") is nothing less than the middlebrow arrival of<n>black studies in American culture. Encyclopedias, after all, are middlebrow,<n>	#journal#	journal_Article247_4070.txt
language, and less sexuality. The biggest advertiser to pull out over content<n>is Coke, which has a wait-and-see attitude about coming back. Another refugee<n>from the sex and violence: the U.S. Army.<n>	#journal#	journal_Article247_4079.txt
[insert blonde starlet here] appears on the cover because she's got a movie<n>coming out doesn't make me want to read the story less--or more. Whereas Tina's<n>insisting that she put Elizabeth Hurley in an extraterrestrial fashion spread<n>	#journal#	journal_Article247_4080.txt
readers to nominate events, significant deaths, good and bad movies, etc.,<n>for 1999--a year likely to get little attention in the coming weeks, as news<n>organizations choose instead to review the entire century or millennium--the<n>	#journal#	journal_Article247_4100.txt
self-importance circulating down here in Austin. Do you remember a couple of<n>weeks ago when Safire wrote in two consecutive columns about coming to see<n>Bush? As I understand it, he called Karen Hughes, Bush's communications<n>	#journal#	journal_Article247_4102.txt
Bush? As I understand it, he called Karen Hughes, Bush's communications<n>director, on, like, a Thursday, and said, "I'm coming Tuesday." Not "Can I<n>come?" but "I'm coming." Karen supposedly said, "Well, the governor's going to<n>	#journal#	journal_Article247_4102.txt
be out of town," to which Safire responded, "No, you don't understand, I'm<n>coming Tuesday." P.S., Bush changed his schedule. Can you imagine David Broder<n>pulling that crap? If the story's true, it lends credence to a theory I have<n>	#journal#	journal_Article247_4102.txt
background is my emergency hyperbole alarm going off.) But if I tend to get<n>overwrought on the subject, it's only because there's so much noise coming from<n>the other side. I couldn't be sicker of hearing how Ordinary People, Folks<n>	#journal#	journal_Article247_4104.txt
the media), I am most concerned by the Safra murder. That is my bank! Between a<n>mysterious murder and Y2K coming up, I could wind up with my checking account<n>erased, and then I would be reduced to ... well, modeling for Oil of Olay. As<n>	#journal#	journal_Article247_4119.txt
otherwise normally intelligent, members of Family K stumble over basic grammar,<n>coming up with sentences like, "The boys eat four cookie." They have trouble<n>creating the plurals of words and forming verbs in the past tense--things most<n>	#journal#	journal_Article247_4121.txt
or is it stiff and smug? Some former supporters, according to the<n>Boston Globe , are deciding he is coming across as,<n>er, "unqualified" to be president. And while they're considering a makeover,<n>	#journal#	journal_Article247_4141.txt
unit, thereby creating the nation's second-largest investment bank. The<n>development, coming on the heels of February's similarly-sized merger of Morgan<n>Stanley and Dean Witter, is widely viewed as signaling the onset of even<n>	#journal#	journal_Article247_415.txt
The WP has a piece inside detailing serious trouble with a book on<n>the Kennedys that My Lai-exposer Seymour Hersh is coming out with this fall. It<n>seems that Hersh had based his project on a cache of secret papers that were<n>	#journal#	journal_Article247_415.txt
for making improvements to the vice presidential official residence. (The story is based on a<n>report coming out today from the Center for Public Integrity.) Gifts include a<n>billiard table, a hot tub, and landscaping. Donors include individuals (not<n>	#journal#	journal_Article247_4172.txt
was creating a world society. The new politics, the new economics, the new<n>technology and the new immigration were coming together to change the tired old<n>rules of the game. There was more in the same poetic vein.<n>	#journal#	journal_Article247_4210.txt
horror. Mao and Pol Pot have a certain claim to being called honorary<n>Westerners, given who their teachers were. And now the century is coming to an<n>end with the Russian army leveling Grozny, as the paper reports this<n>	#journal#	journal_Article247_4211.txt
reopened dozens of SIDS cases.<n>With negotiations on an international global warming treaty coming up in<n>Kyoto soon, the Clinton administration is, according to the WSJ , roiled<n>	#journal#	journal_Article247_421.txt
VandeHei piece. Beinart's just started. And there'll be so many other important<n>things to talk to him about in the coming months!<n>	#journal#	journal_Article247_4251.txt
Today leads with a report that because of the general reluctance to fly<n>this coming New Year's Eve, America's domestic airspace will be nearly<n>empty--only 45 airliners will be aloft--when the next millennium hits. The<n>	#journal#	journal_Article247_4262.txt
entirely to give up the habit of discoursing ironically. It is therefore<n>with some apprehension that Chatterbox views the coming of a new century.<n>Boomer Irony is, after all, a distinctly fin de siècle phenomenon.<n>	#journal#	journal_Article247_4263.txt
of the picture, was what looked like a brilliant shaft of multicolored light,<n>coming from above and directed exactly at Arrigan.<n>The Washington Post photo department, says Quinn,<n>	#journal#	journal_Article247_4269.txt
necessarily be good if it did, would it?<n>In the coming days I want to examine some of Rosen's premises, such as his<n>idea that a declining interest in the news can be linked to journalism as<n>	#journal#	journal_Article247_4281.txt
previous encounters, Gore was highly critical of his rival. But this time he<n>was able to be critical of Bill Bradley without coming off as smarmy or<n>hectoring. Gore made all his familiar criticisms--that Bradley wasn't putting<n>	#journal#	journal_Article247_4313.txt
worries that the Republican Party will enjoy as much as a four-to-one soft<n>money spending advantage in the coming election. Democratic Senatorial Campaign<n>Committee chairman Sen. Robert G. Torricelli projects that the Democrats will<n>	#journal#	journal_Article247_4336.txt
Times rock critic Ann Powers. Weird Like Us: My Bohemian America<n>(Simon & Schuster, $23) is a charming, rambling account of her coming of<n>age as a music-store clerk/riot-grrrl punkster/aspiring writer in Seattle and<n>	#journal#	journal_Article247_4337.txt
ideas--the innovation, the subversion, the re-imagining of the boundaries of<n>society--are coming from. That's the bohemia of the moment. Great American<n>bohemias have bubbled up from the depths in the past, and more surely will in<n>	#journal#	journal_Article247_4337.txt
Both the WP and NYT run stories inside reporting on a piece<n>coming out next week in the Chronicle of Higher Education concerning<n>college president salaries. It turns out that recently retired Northeastern<n>	#journal#	journal_Article247_435.txt
high crime area provides the reasonable suspicion that justifies a<n>stop-and-frisk search. The Washington Post lead, coming in the wake of yesterday's<n>USAT lead claiming that the government would be asking for Microsoft<n>	#journal#	journal_Article247_4366.txt
scandalous, when McCain delivered an answer designed to warm every liberal<n>journalist's heart--especially coming on the heels of Bush's pusillanimous<n>kowtowing on the issue in the South Carolina<n>	#journal#	journal_Article247_4369.txt
describing how DNC ads were helping him "is proof that he was evading the law,"<n>and that according to the Newsweek coming out today, at least one fat<n>cat, Richard Jenrette, has come forward to say Bill Clinton called him up from<n>	#journal#	journal_Article247_436.txt
purge, or rather, purge then binge. Because they feel worthless, they punish<n>themselves by coming in too early to the office and staying too late, whether<n>they need to or not. Then they waste time on endless day trading and deplete<n>	#journal#	journal_Article247_4403.txt
Anyway, from there, the subjects pretty much suggest themselves, and it's<n>just a matter of coming up with the right hook and good lines. For that, I rely<n>on Pico, the Comedy Elf. I type up the subjects I want to spoof and put them<n>	#journal#	journal_Article247_4417.txt
The Bush campaign's technical innovation is the use of "tracking codes," to<n>monitor how much money is coming from its big fund-raisers. Though the<n>euphemism sounds as harmless as a Fedex delivery, this practice allows the<n>	#journal#	journal_Article247_4419.txt
The NYT lead is written off a copy it has obtained of a House<n>committee's report to be released this coming week that says the Defense<n>Department and the Department of Veterans Affairs should be stripped of their<n>	#journal#	journal_Article247_441.txt
my buddy Jerry Van Dyke, Fridays on NBC. ... I was talking to family friend<n>Dick Nixon the other day and he's making rumblings about coming out of<n>retirement and running for president. If he wins the White House, I guarantee<n>	#journal#	journal_Article247_4429.txt
policy paradigm of yesteryear, when the number one enemy of the US was the<n>Soviet Union, to foreign policy threats today, he said: "When I was coming up .<n>. . it was a dangerous world and we knew exactly who they were. It was us<n>	#journal#	journal_Article247_4441.txt
that spanned the shaft between the two elevators, as if these two poor<n>knee-knocking souls were suddenly the second coming of Karl Wallenda.<n>They did it. But can you say 'intensive therapy'?<n>	#journal#	journal_Article247_4463.txt
The company showed strong growth in its wireless business, which remains one of<n>the hottest sectors around, and it issued a bullish forecast for the coming<n>year. But Project Pronto, SBC's $6 billion effort to roll out DSL Internet<n>	#journal#	journal_Article247_4467.txt
to. Where they'll go is wherever as many people as possible will hear them. And<n>there they will brag--as MacDonald has done in a response to Culturebox coming<n>soon to the Fray, and as he probably will in a British court some time in the<n>	#journal#	journal_Article247_4469.txt
have a huge money-raising and spending edge over the Democrats for the<n>elections coming up, but also gives Jiang plenty of top-front coverage.<n>The Jiang headlines at both the WP and LAT emphasize his<n>	#journal#	journal_Article247_447.txt
The WP reports that the Supreme Court has agreed to address for the<n>first time ever the validity of polygraph evidence. The argument isn't coming<n>from prosecutors, but from a defendant who claims a polygraph result would have<n>	#journal#	journal_Article247_447.txt
drug cartels, which nowadays do business with the Russian mafia, and avoid<n>giving a big cut to Mexican distributors by relying more on "mules" coming<n>directly to the U.S. and less on Mexican ships. This change is possible, says<n>	#journal#	journal_Article247_459.txt
forces are still heading to the Persian Gulf. Concerning Saddam Hussein,<n>President Clinton is quoted in all the dailies as saying, "In the coming days<n>we will wait and see whether he does, in fact, comply with the will of the<n>	#journal#	journal_Article247_463.txt
NYT piece frames this as do-nothing action, designed to temporarily<n>quiet demands coming simultaneously from the Israeli right-wing, Palestinians,<n>and the U.S. (which is pressing Netanyahu to cede land quickly). The LAT<n>	#journal#	journal_Article247_468.txt
numerous as cars, they already produce as much carbon dioxide, and by 2010 if<n>the rules aren't changed, they may produce up to 75 percent of all smog coming<n>from personal vehicles.<n>	#journal#	journal_Article247_475.txt
Angeles Times . The New York Times<n>goes instead with a look at the coming debate over the Kyoto greenhouse<n>protocol.<n>	#journal#	journal_Article247_477.txt
Dollar Bill's Diary<n>The coming Washington tax reform debate leads at USA Today . At<n>the New York Times ,<n>	#journal#	journal_Article247_483.txt
economic downturn is good for the U.S. economy or the beginning of a recession<n>here. Both pieces run through the arguments, with the Journal coming<n>down on the side of optimism and the Times piece, while avoiding a flat<n>	#journal#	journal_Article247_487.txt
USA<n>Today leads with a look at the new federal and state tax breaks coming<n>in with 1998. The Washington Post leads with President Clinton's decision to<n>	#journal#	journal_Article247_489.txt
keeps its ledgers hidden.<n>The USAT lead covers the coming fight for lower blood-alcohol limits<n>in drunk driving cases. Several states this year will try to move from a .10%<n>	#journal#	journal_Article247_490.txt
current backlog of them numbers nearly 70,000.<n>The Journal also brings news of a coming marketplace battle as Nike enters the sports equipment<n>biz. Among its products will be a lightweight clamshell baseball glove,<n>	#journal#	journal_Article247_492.txt
crisis, neither of today's Times stories emphasize this.<n>According to the LAT front, a study coming out today from the Simon<n>Wiesenthal Center will charge that thousands of Jewish refugees were confined by the Swiss during<n>	#journal#	journal_Article247_497.txt
But, the Journal points out, with spending in the public health care<n>sector (primarily Medicare and Medicaid) coming under firmer budgetary control,<n>the growth of private medical costs may be poised to rise above 5% per year for<n>	#journal#	journal_Article247_497.txt
if they'd gone with "not really thrilled.")<n>The WSJ says that Hallmark Cards is coming out with a sympathy card<n>for relatives of those who've committed suicide.<n>	#journal#	journal_Article247_499.txt
third state to settle such a case, joining Florida and Mississippi. There are,<n>says the paper, a total of 40 such suits on file, with Minnesota's turn coming<n>next week.<n>	#journal#	journal_Article247_500.txt
The NYT lead is accompanied by a large picture of Bill and Hillary<n>coming out of church yesterday morning sharing a big ole laugh with the<n>minister. (They must have really enjoyed the sermon, "The Eight Commandments.")<n>	#journal#	journal_Article247_506.txt
broke down in tears in the middle of a speech.<n>The Journal editorial "Bonfire of the Presidency" counters the suggestion coming<n>from some quarters that Monica L. has an overactive imagination with the<n>	#journal#	journal_Article247_506.txt
provisions dealing with child care, transportation, and tobacco taxes. The<n>Journal sees the big conflicts coming over the expansion of Medicare to<n>those younger than 65, a minimum wage increase, and national teacher<n>	#journal#	journal_Article247_512.txt
illegal immigration arrests skyrocket.<n>Yesterday's WP said that Willey was coming to the Starr grand jury,<n>but nobody predicted this soon. The papers seize on various indications that in<n>	#journal#	journal_Article247_538.txt
nuclear bomb near the asteroid. The Times also mentions that two movies<n>coming out later this year deal with the scenario of threatened interstellar<n>collisions. The producers of those movies must just be sooo upset about<n>	#journal#	journal_Article247_539.txt
Today leads with Kathleen Willey's lawyer's defense of her motives in<n>coming forward. The Washington Post leads with the apparent intention of<n>President Clinton's lawyer in the Paula Jones case, Robert Bennett, to submit<n>	#journal#	journal_Article247_545.txt
be...fatal. This is a sad, sad story, but legally and morally irrelevant. To<n>think otherwise is to opt for making coming up behind someone and saying "Boo"<n>a crime, because yes, it just might possibly scare him to death.<n>	#journal#	journal_Article247_550.txt
about 26.7 percent ten years ago.<n>A piece inside the WP (about an article coming out today in the<n>scientific journal Nature ) reports that a New York scientist, Stuart<n>	#journal#	journal_Article247_554.txt
buying television ads just before last Thanksgiving for the primary vote this<n>coming June. Checchi's standard, says the Times , promises to lead to the<n>most expensive state election in history.<n>	#journal#	journal_Article247_562.txt
The Los<n>Angeles Times leads with a new study coming out in JAMA today<n>concluding that properly prescribed drugs kill more than 100,000 people a year,<n>	#journal#	journal_Article247_563.txt
What Lehrer was beating around the bush about is that Taylor recently admitted<n>he'd talked to Ken Starr about coming to work for him, and then decided not to.<n>It's far from clear to "Today's Papers" why this is any kind of a firing<n>	#journal#	journal_Article247_563.txt
with commentator David Gergen, who while still on the show talked to Bill<n>Clinton about coming to work for him before actually doing so.<n>If you've just now finished your tax return, you'll be glad to know that<n>	#journal#	journal_Article247_563.txt
And the Times explains that some senators are concerned that more and<n>more new members will be coming in, hurting NATO's strength. It occurs to<n>"Today's Papers" though, that here may lie the true solution: Let any country<n>	#journal#	journal_Article247_573.txt
A front-page LAT story and one inside at the NYT cover a<n>sociological finding coming out today in the journal Science . It's well<n>known that people will under-report their questionable behavior when asked<n>	#journal#	journal_Article247_580.txt
how this problem can be resolved, and so it's hard to see how the proposed<n>vaccine tests can avoid coming acropper like the recent controversial AIDS<n>research in Africa these papers reported on at some length.<n>	#journal#	journal_Article247_599.txt
This is not really anti-feminist, since much of the new laddism seems to be<n>coming at the behest of a new generation of Cosmo-trained sex-addled<n>fembots. How terrifying Monica Lewinsky's blithe attitude toward phone sex must<n>	#journal#	journal_Article247_5.txt
makes front-page "reefers" at the LAT and USAT .<n>The WP runs an AP item about a JAMA study coming out today noting<n>that the number of disciplinary actions taken against physicians for<n>	#journal#	journal_Article247_608.txt
Rehnquist, who handles emergency matters for the Washington federal courts<n>(and who, the papers note, is coming into town from Innsbruck, Austria, where<n>he was teaching a summer course) is getting the case of what to do about subpoenas issued by Kenneth Starr<n>	#journal#	journal_Article247_630.txt
The Weak, The Spin<n>Washington news, most of it coming out of Congress' summer session,<n>dominates. The New York Times<n>	#journal#	journal_Article247_637.txt
that Hispanics work admirably hard. Also, a polling firm finds that 94% of<n>Hispanic workers claim to "work hard at coming out on top" while only 64% of<n>non-Hispanic adults say the same. From the same Work Week column we learn that<n>	#journal#	journal_Article247_641.txt
Rauschenberg retrospectives. Five thousand people a day, most of them who've<n>never before been to the Guggenheim or any other museum, are coming to see a<n>display of motorcycles. One featured lecturer: Dennis Hopper.<n>	#journal#	journal_Article247_647.txt
reports that Clinton tentatively approved the mission on August 14th, with the<n>final go-ahead coming in a 3 AM phone call yesterday morning.<n>The WP quotes a spokesman for the Taliban, the Afghan ruling group,<n>	#journal#	journal_Article247_665.txt
Week this morning, furrow-browed and "heartbroken with all the evidence<n>coming out" against the president. Last week, when the Lewinsky story was only<n>a few hours old, Stephanopoulos popped up on Good Morning America to<n>	#journal#	journal_Article247_66.txt
the Washington Post each put the ruble inside and go<n>instead with the likely coming ashore today in the Carolinas of Hurricane<n>Bonnie, packing 115 mph winds across an extremely broad front. The storm has<n>	#journal#	journal_Article247_670.txt
Cohen's recommendations of an optimal portfolio mix. The Post emphasizes<n>the human side, with a tale of a broker abruptly coming back in to work from a<n>family vacation, and two stories about brokers making reassuring calls to their<n>	#journal#	journal_Article247_677.txt
And the Mirage Resorts in Las Vegas has hired 26 ex-offenders in recent years,<n>mostly young people coming out of a state-run boot camp, for jobs in<n>landscaping, flower arranging, and maintenance and custodial work. Mirage has<n>	#journal#	journal_Article247_682.txt
The Post goes with President Clinton's attempts to marshal congressional<n>support for the coming storm. The LAT leads with the Dow's biggest 1-day<n>point gain ever, which is the off-lead at the WP , and is also fronted at<n>	#journal#	journal_Article247_684.txt
of possible impeachment proceedings. Similarly, the Wall Street Journal "Washington Wire" says the Starr report<n>means the chances of a managed care overhaul coming out of Congress this year<n>are zero.<n>	#journal#	journal_Article247_686.txt
rise, explains the WSJ , stems from Britain's decision to opt out of the<n>coming common European currency, the euro. The eleven euro countries were<n>required to cut government spending and raise taxes, and Britain wasn't, with<n>	#journal#	journal_Article247_689.txt
without a public figure in Britain, Germany, or the United States hailing the<n>coming of the Third Way," laments Tony Judt in an NYT piece.<n>Bingo, Tony! The op-ed page in today's WP "Outlook" features a piece by none other than British Prime Minister Tony Blair,<n>	#journal#	journal_Article247_703.txt
anti-Gingrich defense of Clinton last Sunday.<n>Stories inside the NYT and WP report that a study coming out<n>today demonstrates the shortcomings of a flagship program designed to help poor<n>	#journal#	journal_Article247_705.txt
explain, the parties now disagree about what to do with the surplus--Clinton<n>wants to reserve it for dealing with the coming Social Security crunch,<n>although he wants to use some of it for keeping U.S. troops in Bosnia and to<n>	#journal#	journal_Article247_707.txt
products, which the Wall Street Journal says portends healthy U.S.<n>manufacturing activity in the coming months, means nothing right now. It's a<n>duck/rabbit world, economics, and right now, as the papers make clear, it's all<n>	#journal#	journal_Article247_708.txt
that most of the top House majority positions will be up for grabs in the<n>coming days, pitting GOP personalities and ideological factions against each<n>other. All the papers mention Oklahoma Rep. Steve Largent as a serious threat<n>	#journal#	journal_Article247_747.txt
leads also note that several other top House Republican slots are likely to be<n>contested in the party vote coming up on November 18th.<n>The NYT makes the point that Livingston, Cox and other members of the<n>	#journal#	journal_Article247_748.txt
look like the one-man show it often is." Another Fed decision on interest rate<n>cuts is coming today.<n>Monica Lewinsky has signed a book deal with St. Martin's Press, a story<n>	#journal#	journal_Article247_759.txt
primarily dedicated to economic issues. The LAT says the White House did<n>not count on the scandal coming up, because of the "Japanese people's famous<n>reserve."<n>	#journal#	journal_Article247_763.txt
The WSJ runs a useful feature describing what signs to look for to<n>tell if the global economic crisis is coming to a close. The list includes:<n>When the financial markets yawn in the face of bad news, when yields on<n>	#journal#	journal_Article247_763.txt
them) to cheese companies has been finding new ways to do this, and parents<n>are, says the paper, finding more product solicitations coming home in their<n>kids' backpacks. The good deals and cut rates are often dangled as a way to<n>	#journal#	journal_Article247_767.txt
PAC" for the 2000 Presidential campaign.<n>The NYT front hints at a coming waterloo for Yugoslav dictator<n>Slobodan Milosevic. The evidence is a spate of recent purges of government<n>	#journal#	journal_Article247_773.txt
slave labor--Ford and GM.<n>USAT explains that new Health and Human services regulations coming<n>out this week would make it clear that hospitals cannot delay care while<n>	#journal#	journal_Article247_774.txt
The LAT front reports that new studies show that although AIDS was<n>slow in coming to South Africa, that country is now the place on the planet<n>hardest hit by the disease. The infection rate there is now one new person per<n>	#journal#	journal_Article247_775.txt
The NYT reports that the 11-nation European interest cut is a drastic<n>shift in policy, coming just two months after these same central bankers<n>adamantly refused to cut because of fears of inflation. But it's clear now,<n>	#journal#	journal_Article247_778.txt
says Reno is right because the campaign finance laws are vague and weak, and<n>notes that the anger about her decision coming from Congress is ironic since<n>Congress could most easily remedy this.<n>	#journal#	journal_Article247_782.txt
rising rapidly, now taking place at the rate of about 8,000 per year.<n>Both the NYT and the WP report that this coming Sunday night,<n>"60 Minutes" producer Don Hewitt will appear on the show to apologize for a<n>	#journal#	journal_Article247_786.txt
doesn't explain why the reverse couldn't turn out to be true instead.<n>It has always seemed a little odd for papers to insist on coming out on such<n>dead news days as Christmas and New Years. A lot of it is just so much<n>	#journal#	journal_Article247_809.txt
senatorial heads talked, according to the LAT --and the main new<n>information coming from them is that some senators think President Clinton<n>should postpone his State of the Union address if the scheduled date--January<n>	#journal#	journal_Article247_812.txt
which is U.S. practice, because missiles are many times faster than airplanes.<n>More likely is that the Iraqi pilots saw the missiles coming and then, probably<n>with the help of distracting countermeasures, made sudden maneuvers the<n>	#journal#	journal_Article247_814.txt
A front-page LAT piece observes that there are a number of<n>anniversaries coming up in China this year that could stimulate popular<n>political expression and the government's repression of same: the 10th<n>	#journal#	journal_Article247_820.txt
its front, which makes sense since the decision to pay was reached two months<n>ago (the only real news coming with the actual check is that nearly half of the<n>money was Hillary's). USAT puts it on page 12, thereby enabling it to<n>	#journal#	journal_Article247_822.txt
and provides them exclusively to readers of this column:<n>"Yes, yes, it's coming back to me now,...a white Fiat Uno driven by a<n>papparazzi! And he's yelling...what?...oh, yes, he's yelling 'we're out to get<n>	#journal#	journal_Article247_83.txt
reverent devotees, he meditated and preached on race, poverty, morality, and<n>the significance of the coming millennium. "Children screamed. Grown women<n>shrieked. Little girls cried from happiness," the story recounts. Sure, the<n>	#journal#	journal_Article247_840.txt
two impeachment articles from winning a simple majority.<n>In light of the presumed outcome, the WP sees the rhetoric coming<n>yesterday from both sides--each of the 13 House prosecutors and President<n>	#journal#	journal_Article247_851.txt
stumbling in its court defense. A forced breakup is currently envisioned by the<n>government as coming in two flavors: 1) Carve MS into one company that sells<n>only the Windows operating system and one that would sell other MS software<n>	#journal#	journal_Article247_857.txt
Stories in the Wall Street Journal and the WP describe a study<n>coming out today in JAMA concluding that doctors examining young children<n>frequently miss head injuries linked to child abuse. The study holds that<n>	#journal#	journal_Article247_859.txt
president's function is to be a "role model," as opposed to simply an effective<n>president. Alas, the evidence keeps coming in that the "role model" effect is<n>real. The latest? This week's study in the Journal of the American Medical<n>	#journal#	journal_Article247_86.txt
word in the feminist-Holocaust literature, but found it nowhere. If it has been<n>used, it has clearly not been used frequently, and so is not coming at us from<n>"every side."<n>	#journal#	journal_Article247_905.txt
contributions, stolen mostly from Variety : A new book is about to come<n>out that seems likely to amount to a city-wide coming out: Open Secret: Gay<n>Hollywood 1928-1998 . Tom Cruise has already threatened to sue, even though<n>	#journal#	journal_Article247_910.txt
confirmation of rumor always makes. Had the world known for certain that the<n>incredible stories coming from the Soviet Union were true, more Jews could have<n>been warned. Neutral and satellite states could have been pressured to accept<n>	#journal#	journal_Article247_916.txt
their agents and publicists and were leaving Hollywood--they were sick of the<n>homophobia they'd experienced since coming out as lesbians last year.<n>"Everything that I ever feared happened to me," DeGeneres said. "I lost my<n>	#journal#	journal_Article247_924.txt
and today she reprises Janet Leigh's role in Psycho as the most<n>notorious murder victim in film history. DeGeneres has two movies coming out<n>(one a Ron Howard comedy) and is set to do a standup tour later this<n>	#journal#	journal_Article247_924.txt
television column by Michelle Cottle, which will appear at the end of each week<n>and cover the coming week in television. We know that when it comes to TV,<n>everyone's a critic, so we invite you to send your picks, pans, and flames to<n>	#journal#	journal_Article247_927.txt
rising tide of warm-and-fuzzy holiday programming can be harrowing.<n>In the coming week, viewers will be bombarded with holiday episodes of<n>everything from The X Files to Two Girls, a Guy, and a Pizza .<n>	#journal#	journal_Article247_927.txt
her diaphragm into some Salvation Army Santa's collection basket.<n>The coming week also delivers a sleigh-full of holiday movies and specials.<n>Of course there are the requisite showings of  Miracle on 34th Street<n>	#journal#	journal_Article247_927.txt
speaks with some authority as ranking Democrat on the Senate Finance Committee.<n>His plan was also considered radical, coming from a Social Security defender,<n>because it suggested using part of Social Security's payroll tax to fund<n>	#journal#	journal_Article247_92.txt
lumberjack finals.<n>OK. There are, in fact, 14 bowl games in the coming<n>week, and pro wrestling is more "sports entertainment" than actual sport.<n>	#journal#	journal_Article247_930.txt
solid. But if nothing this week grabs you, take heart: The lockout is over, and<n>NBA action should be coming your way soon.<n>-- Michelle Cottle<n>	#journal#	journal_Article247_932.txt
Idiot Box: Lemming Chic<n>Before delving into the coming week's programming, I have to ask: Why do<n>they keep letting Bob Woodward appear on Larry King Live ? I understand<n>	#journal#	journal_Article247_935.txt
fears of opponents of Proposition 209, which eliminated racial preferences in<n>California's public institutions, seemed to be coming true--despite the efforts<n>of UC officials to compensate for the end of race preferences by giving an edge<n>	#journal#	journal_Article247_93.txt
didn't feel like directing, production of Eyes Wide Shut shut down. What<n>would be the point of coming in?<n>Those who've had experiences with amphetamines can<n>	#journal#	journal_Article247_948.txt
dispel them with the dreamlike reasonableness of a ministerial counseling<n>session. The 18-year-old son is grounded for coming in late? Just when you<n>expect him to clutch his head and moan, like James Dean in Rebel Without a<n>	#journal#	journal_Article247_949.txt
and letting the market take care of most people's healthcare, and the<n>government coming in to rescue those who fall through the cracks. This would<n>probably lead, I'd guess, to more social spending on health-care as a<n>	#journal#	journal_Article247_973.txt
evidence that troops encountered many different chemical agents which,<n>they believe, made thousands ill after coming home. Troops received multiple<n>immunizations , including uncommon vaccines against anthrax and botulinum<n>	#journal#	journal_ArticleIP_1026.txt
Remedies 1 and 2 are<n>already taking place. The third is coming soon. All of them will make the<n>Internet easier to use. And in the short term, all of them will make the<n>	#journal#	journal_ArticleIP_1036.txt
grandmother Edith had a morphine problem. Corollary theory: The risks of<n>getting caught with Lewinsky added to the thrill and kept him coming back for<n>more. Alter says that he may even "get off on" the "brush[es] with political<n>	#journal#	journal_ArticleIP_1084.txt
Slate<n>features available this way in the coming<n>months.<n>	#journal#	journal_ArticleIP_11221.txt
and women at CNN who will be working so hard and with such pleasure in the<n>coming days. God bless America.<n>Adam Bonin's<n>	#journal#	journal_ArticleIP_11254.txt
come back to me that she is bad-mouthing me whenever she can. With Christmas<n>and New Year's coming up, we will be seeing more of her than ever. I do not<n>need this aggravation, Prudie, and fear she is harming my reputation. Any<n>	#journal#	journal_ArticleIP_11714.txt
damaging my career if it gets out," she says.) The magazines agree that: 1) her<n>TV coming out is a milestone because it's the first time a show will have a<n>lead gay character; 2) advertisers and viewers won't strongly object; and 3)<n>	#journal#	journal_ArticleIP_1174.txt
interfere with every aspect of private life. An article makes fun of Ellen<n>DeGeneres' TV/real-life coming out: It is a "cynical marketing ploy."<n>The<n>	#journal#	journal_ArticleIP_1176.txt
editors or quotes from people such as Laurie Anderson, Noam Chomsky, and Andy<n>Grove. (For example, a picture of a woman with tubes coming out of her head is<n>captioned, "Technology is the campfire around which we tell our stories.")<n>	#journal#	journal_ArticleIP_1208.txt
especially a ban on partial-birth abortions and a tax cut. An article says the<n>Lewinsky case will scare "many potential John Deans" into coming forward and<n>revealing more Clintonian crimes. ... The Standard warns that<n>	#journal#	journal_ArticleIP_1214.txt
the support of labor leaders and progressives--essential to winning the<n>nomination. Why no challenge coming from Gore's left? Democrats have decided<n>there's no chance another candidate might win. ... An article describes<n>	#journal#	journal_ArticleIP_1237.txt
controversy: Actor Antonio Banderas accepted, then rejected, the role of<n>Atatürk in an coming biopic.)<n>New<n>	#journal#	journal_ArticleIP_1240.txt
unsmiling--so driven, in every sense--that they make you ashamed of ever having<n>enjoyed yourself." Cronenberg and Ballard should not even get credit for coming<n>up with a novel idea, says New York 's David Denby: "The men and women<n>	#journal#	journal_ArticleIP_1274.txt
But that free servitude still can pierce our hearts.<n>Our life is changed; their coming our beginning.<n>	#journal#	journal_ArticleIP_13105.txt
TV<n>Ellen 's coming out is hailed as the year's highlight, a "seminal moment"<n>in television history (Howard Rosenberg, the Los Angeles Times ). Critics<n>	#journal#	journal_ArticleIP_1310.txt
too, we learn the salient facts of an artist's development without really<n>coming to understand how they happened. In Paris before and during World War I,<n>Rivera was a member of the French avant-garde, executing competent Cubist works<n>	#journal#	journal_ArticleIP_13193.txt
(Warner Bros.). Critics praise The Crying Game<n>director Neil Jordan for his dark coming of age tale. They particularly like<n>his deft black humor and "gift for genuinely shocking his audience" (Janet<n>	#journal#	journal_ArticleIP_1325.txt
(Buena Vista Pictures). Lipstick lesbian Anne Heche<n>wins praise for her first leading role since coming out. Though some had<n>doubted she'd make a convincing straight woman, the Washington Post 's<n>	#journal#	journal_ArticleIP_1335.txt
followed by a nasty recession. But whereas the United States soon recovered and<n>experienced a decade of roaring prosperity before the coming of the Great<n>Depression, Britain's slump never really ended. Unemployment, which had<n>	#journal#	journal_ArticleIP_13630.txt
medical-insurance nightmares conjured up in 1994 by enemies of the<n>Clinton health-care plan are coming to pass anyway. A group of former<n>independent counsels (a k a special prosecutors), including Watergate's<n>	#journal#	journal_ArticleIP_1380.txt
and, above all, Democrats will sing from Gingrich's rap sheet throughout the<n>coming hearings on Clinton's ethical troubles. White House aides<n>reportedly were delighted by the outcome. Commentators chuckled that the GOP<n>	#journal#	journal_ArticleIP_1388.txt
Northwest's woes to biblical plagues ("We finally got our natural disaster, as<n>if it were coming to us," conceded a Seattle coffee server) and reporting that<n>"some Northwesterners" confess to a "sheltered, even slightly wimpy quality in<n>	#journal#	journal_ArticleIP_1388.txt
and more cops on the beat. The New York Times reports that debutante<n>balls are coming back. A study finds promise in a new therapy for impotence: a<n>drug pellet that is inserted into the man's urethra. (Fewer than one in 40 men<n>	#journal#	journal_ArticleIP_1388.txt
Indian religion notorious for animal sacrifice, is gaining American adherents<n>and coming out of the closet. New studies show that 1) one in seven black<n>men can't vote because of a felony conviction; 2) cities in the North and<n>	#journal#	journal_ArticleIP_1396.txt
only incense greets him<n>coming back into the room<n>stretched on the floor<n>	#journal#	journal_ArticleIP_14013.txt
after the Israeli elections in May, while the Jan. 24 meeting will issue a<n>"balanced" statement opposing fresh U.S. strikes against Iraq and also coming<n>out against assistance to the Iraqi opposition in its goal of bringing down<n>	#journal#	journal_ArticleIP_14363.txt
instructing prosecutors not to manipulate the jury's emotions. The early line<n>on the coming trial of alleged co-conspirator Terry Nichols is that he'll be a<n>lot harder to convict because he was home in Kansas when the bomb went off in<n>	#journal#	journal_ArticleIP_1436.txt
The<n>Teletubbies are coming . The colorful British toy characters, designed to<n>appeal to 1- and 2-year-olds, speak in baby talk, smile, hug, and roll on the<n>	#journal#	journal_ArticleIP_1545.txt
owners of Seagrams also control Universal Studios and MCA. Just as Disney's<n>101 Dalmatians is coming to neighborhood theaters, Crown Royal's twin<n>vizslas are coming into your homes. Man's best friend, the ad seems to tell the<n>	#journal#	journal_ArticleIP_1582.txt
101 Dalmatians is coming to neighborhood theaters, Crown Royal's twin<n>vizslas are coming into your homes. Man's best friend, the ad seems to tell the<n>best of men, is telling us that Crown Royal is man's best drink.<n>	#journal#	journal_ArticleIP_1582.txt
Future," as the narrator asserts that "America deserves better." Whether the<n>voters deserve it or not, we're likely to hear a lot more in coming spots about<n>which man is better--or worse. It may be a long-shot strategy, but Dole is far<n>	#journal#	journal_ArticleIP_1585.txt
each other, Pops issues his warning from the back seat ("Look out!"),<n>previewing the coming assurance that while the GTI can race along, it still has<n>room for four. It's instantly maneuverable, too. Speed slips through the seam<n>	#journal#	journal_ArticleIP_1597.txt
be a long step, some would say--and the statistics show that for an increasing<n>number of teens, the smoke is coming from marijuana. But this one hasn't taken<n>that step--yet. She's standing stock-still for now, the voice that acknowledged<n>	#journal#	journal_ArticleIP_1605.txt
curves around a gyrating graphic, "it takes off those leaves. Then, it keeps<n>them from coming back." We aren't sure what "it" is, but clearly, this product<n>aids aging. Leaves wither and fall as the plant continues to dance--the<n>	#journal#	journal_ArticleIP_1618.txt
The stock<n>market will continue to prosper in the coming months if more Chinese money<n>rushes into town. One Hong Kong-based brokerage estimates that inflows will<n>	#journal#	journal_ArticleIP_1648.txt
Topic A on the weekend talk<n>shows was China, with Campaigngate coming in second and the Microsoft tussle<n>with the Justice Department a distant third.<n>	#journal#	journal_ArticleIP_1657.txt
(Mara Liasson of Fox News Sunday ) asked why the commander in chief<n>wasn't mobilizing public opinion for the coming clash. No problem, said all the<n>president's persons, who swarmed the weekend shows, conducting well-scripted<n>	#journal#	journal_ArticleIP_1660.txt
has to be followed up by the threat of ground troops," said Kristol. The silver<n>lining of the coming war, Kristol smiled, was that it, NATO expansion, and the<n>troops in Bosnia would make 1998 a "foreign-policy year."<n>	#journal#	journal_ArticleIP_1660.txt
( The McLaughlin Group ) denounced the "crony capitalism" of Asia and<n>predicted that the coming International Monetary Fund bailout will run into the<n>hundreds of billions of dollars. Kate O'Beirne ( NewsHour ) called the<n>	#journal#	journal_ArticleIP_1662.txt
Germany supports the treaty because the closure of East Germany's dirtiest<n>factories has already brought the Germans into compliance with the coming<n>emission standards, which are set at 1990 levels.<n>	#journal#	journal_ArticleIP_1664.txt
fostering the notion that he was returning to ABC as some sort of superpundit.<n>Then he explained that in coming weeks he'd be talking about nutrition and<n>agriculture in the service of ADM. Brinkley's appearance as a pitchman in the<n>	#journal#	journal_ArticleIP_1667.txt
topic strained the pundits' omniscience. Tony Blankley described it as the "one<n>glimmer of light coming out of the Middle East for America." Al Hunt (CNN's<n>Capital Gang ) asked, "Is Khatami the Gorbachev of the Middle East?"<n>	#journal#	journal_ArticleIP_1668.txt
thing: Cokie Roberts ( This Week ) framed the question in terms of<n>"survival" of the Clinton presidency. Bill Kristol saw the end coming in a<n>matter of days; George Stephanopoulos blushed at the prospect; and George Will,<n>	#journal#	journal_ArticleIP_1670.txt
Carlson ( Capital Gang ) complains about the unfair leaks emanating from<n>Starr's office, an odd gripe coming from a D.C. journalist, given that their<n>business would shut down overnight if leaks were plugged. Eleanor Clift<n>	#journal#	journal_ArticleIP_1671.txt
finance, tobacco, and education are Issues 1 through 3. The sex scandal plays<n>as background music, coming in as Issue 4. Paula Jones' appearance at the White<n>House Correspondents' Dinner--where the pundits spent Saturday evening--is<n>	#journal#	journal_ArticleIP_1683.txt
jeers that "[Clinton is] trying to do a job in Israel--too bad his wife doesn't<n>agree with him." An unremarkable snipe coming from a noted anti-Clintonite,<n>except that this particular snipe comes from Mary Matalin, who spent a<n>	#journal#	journal_ArticleIP_1685.txt
Hume. Tripp's testimony will be a "bombshell," says Stephanopoulus. Tripp's<n>testimony is proof that Starr's inquiry is coming to a close, say others.<n>(Caveat emptor: the same voices that have been predicting a close for<n>	#journal#	journal_ArticleIP_1692.txt
Group ) said she would testify "very soon." Three weeks ago Novak<n>( Capital Gang ) announced, "this thing is coming to a head," while David<n>Gergen ( The McLaughlin Group ) guessed that Lewinsky would testify in two<n>	#journal#	journal_ArticleIP_1695.txt
out Clinton lawyer Bob Bennett as the person mainly responsible for bringing<n>disaster on the president. "If it had not been for Bob Bennett coming out on TV<n>and saying that Paula's story was 'tabloid trash for cash' ... this whole thing<n>	#journal#	journal_ArticleIP_1713.txt
that, with this, President Boris Yeltsin has effectively given up power and<n>Novye Izvestiya that his second coming is attributable not to any<n>failings by Chernomyrdin's predecessor, Sergei Kiriyenko, but to Yeltsin's<n>	#journal#	journal_ArticleIP_1770.txt
editorial that "she restored to royal life the quasi-religious ideal of the<n>exalted coming down among the meek. ... Without knowing it, Diana revived and<n>modified the medieval tradition of the 'royal touch,' bringing hope if not<n>	#journal#	journal_ArticleIP_1771.txt
Japanese Prime Minister Keizo Obuchi. "With the global economy showing signs of<n>coming apart at the seams, it is truly disappointing that the leaders of the<n>two countries who ought to be co-operating to prevent a worldwide crisis are<n>	#journal#	journal_ArticleIP_1777.txt
any of the logistics of his testimony will be revealed, whether he will answer<n>all questions from Starr, whether Starr is coming to the White House, whether<n>McCurry has talked to Clinton's lawyers, whether McCurry has talked to the<n>	#journal#	journal_ArticleIP_1803.txt
frequently: It used to arrive every five to eight years; recently it's been<n>coming every three to five years. Scientists are befuddled about its<n>relationship (if any) to global warming: Some say global warming is making El<n>	#journal#	journal_ArticleIP_1833.txt
Economics Dean Anthony Giddens. Prospect adds that the best sociological<n>research is coming from independent think tanks and corporations, not from<n>universities.<n>	#journal#	journal_ArticleIP_18415.txt
his byline and photo on the dust jacket? He had no idea it was so bad. After<n>coming up with the idea for the project and appointing an "associate editor" to<n>run it, he says, he was only minimally involved. According to those who edited<n>	#journal#	journal_ArticleIP_1860.txt
George Will has a book<n>coming out this week. This normally would not qualify as news, since George<n>Will always has a book coming out and it is usually disappearing quietly into<n>	#journal#	journal_ArticleIP_1861.txt
coming out this week. This normally would not qualify as news, since George<n>Will always has a book coming out and it is usually disappearing quietly into<n>the back catalog of the Conservative Book of the Month Club ( The Woven<n>	#journal#	journal_ArticleIP_1861.txt
records albums in even less time. Everything is branded and tied together: All<n>No Limit albums advertise coming albums by other No Limit artists. He makes<n>movies in order to sell soundtracks. The cross-marketing works: No Limit CDs,<n>	#journal#	journal_ArticleIP_1872.txt
Now I don't doubt for a moment that if you put<n>a group of bureaucrats around a conference table, the chances of them coming up<n>with sensible rules for beach volleyball, much less the seminal concept, are<n>	#journal#	journal_ArticleIP_1880.txt
crowned heads, fainted upon meeting Abe, or so she said. But then she is also<n>reported to have heard Andrew Jackson's ribald laughter coming from her bed in<n>the Rose Bedroom.<n>	#journal#	journal_ArticleIP_1897.txt
the American Heritage Dictionary and is now the North American editor of<n>the Encarta World English Dictionary , recalls coming across the word<n>these days mostly in speech, "especially in sardonic and sarcastic replies to<n>	#journal#	journal_ArticleIP_19066.txt
Award nominations were announced. Shakespeare in Love gathered 13<n>nominations, beating Saving Private Ryan (which won 11) and coming<n>within one of the record. Critics agreed that the big theme is World War II:<n>	#journal#	journal_ArticleIP_19177.txt
to cut gasoline taxes to offset a temporary price rise. Not many voters stopped<n>to ask where the money was coming from. So what politician will be foolish<n>enough to take the first step in trying to institute new taxes on all-American<n>	#journal#	journal_ArticleIP_1919.txt
was, "It does not take a village to raise a child. It takes a family to raise a<n>child." Pretty nervy line, coming from a man who left his first wife and their<n>daughter. Then again, some people found it nervy when Bill Clinton, at a<n>	#journal#	journal_ArticleIP_2013.txt
in retrospect, no ordinary plan. It went quite awry. Some of the projected $7<n>million--at least $1.2 million, according to the Times --wound up coming<n>in the form of improper or illegal donations (which, of course, we already knew<n>	#journal#	journal_ArticleIP_2017.txt
might well suspect some kind of subliminal messaging. The four tubbies have<n>aerials coming out of their spacesuit hoods, which receive programming that's<n>broadcast on TV screens in their tummies. As they prance out of their bunker<n>	#journal#	journal_ArticleIP_20251.txt
ironclad. If you juggle those initial assumptions a bit, you'll get a number<n>other than 150 percent coming out at the end, and you might or might not<n>discover a scenario in which discrimination is plausible. (My guess is that you<n>	#journal#	journal_ArticleIP_2039.txt
chance. In the final hours of the Republican National Convention, reporters<n>were still writing that Dole was only just coming to grips with his<n>infirmity.<n>	#journal#	journal_ArticleIP_2067.txt
In dividing all art into two categories, Nietzsche rendered<n>the service of coming up with one of the great intellectual parlor games of all<n>time. Critics love to devise variations for their fields. Richard Martin, the<n>	#journal#	journal_ArticleIP_20781.txt
class bias against what one Washington bureau chief called "some sleazy woman<n>with big hair coming out of the trailer parks." But that's not all of it. Not,<n>that is, unless you believe that the press would have given similar coverage to<n>	#journal#	journal_ArticleIP_2085.txt
the debate over late-term abortions, and the Fitzsimmons affair is their<n>disingenuous strategy coming back to bite them. Instead of categorically<n>defending a woman's right to an abortion, they have chosen to challenge<n>	#journal#	journal_ArticleIP_2086.txt
so many jokes about worrying about carrying the worry gene that I'll spare you<n>my own. The coming of the rain has only added weight to the sinking realization<n>that I'm about as free as Pavlov's best friend, acting as it does as cold<n>	#journal#	journal_ArticleIP_2135.txt
Seattle's spacey 1962 fantasy about itself is<n>finally coming true these days as Gates and another home-grown billionaire,<n>Craig McCaw, have partnered in a telecommunications company by the name of<n>	#journal#	journal_ArticleIP_2136.txt
amateurish and obnoxious could have been a combination of nervousness and<n>inexperience. Here was an obviously experienced man coming into this young<n>upstart's company, probably extremely well-dressed and with credentials earned<n>	#journal#	journal_ArticleIP_21502.txt
women. It's not that they necessarily dislike me, nor I them, it's just that<n>everything feels so uncomfortable. Prom is coming up, and I am currently<n>wondering whether or not to ask anyone. Everyone around me is telling me I HAVE<n>	#journal#	journal_ArticleIP_21502.txt
that the name "SLATE" is appropriate, because whenever he asks anyone from<n>Microsoft, "How's your project coming along?" the answer he usually gets is,<n>"'s late." SLATE , in fact, has been reasonably prompt. Less than six<n>	#journal#	journal_ArticleIP_2162.txt
And<n>coming up soon, two additional Back of the Book features: an interactive<n>acrostic puzzle, and a stock-market contest.<n>	#journal#	journal_ArticleIP_2162.txt
"Oh my<n>God! The call is coming from inside the house!"-- Eric "Just Watched<n>Urban Legend " Fredericksen<n>	#journal#	journal_ArticleIP_21643.txt
was John Cusack, who started his career with a minor role in Sixteen<n>Candles. The second coming of John Hughes was the writer and director<n>Cameron Crowe, who cast Cusack in Say Anything ..., a funnier and more<n>	#journal#	journal_ArticleIP_21663.txt
was too cumbersome. Try the new model; we think you'll like it. Other design<n>changes and "tweaks" will be coming along as this experiment continues.<n>What's<n>	#journal#	journal_ArticleIP_2167.txt
government, which had distanced itself from Pollard, embraced him. And during<n>the past three years, mainstream Jewish groups have started coming around.<n>Almost every significant Jewish organization now supports Pollard's release,<n>	#journal#	journal_ArticleIP_21687.txt
lawn for money. Is it? Could it be? (I hope I'm not spoiling anything--all this<n>is in the film's coming attractions.)<n>The first part of The Deep End of the Ocean is<n>	#journal#	journal_ArticleIP_21711.txt
Slate<n>has been coming out, the<n>company has not interfered in editorial decisions in any way. Nor has any<n>	#journal#	journal_ArticleIP_2217.txt
minister, with Germany's Die<n>Welt coming out Monday in his support. "The name of Romano Prodi is a<n>synonym in Italian for integrity and economic competence," the paper said. It<n>	#journal#	journal_ArticleIP_22277.txt
that's why I'm not asking you to believe it, I'm only asking you to believe<n>that I believe it. Why are you coming at me with that pillow? Urgggghhhh<n>..."<n>	#journal#	journal_ArticleIP_2228.txt
That's an encouraging rate of growth. But how can we have 10 times as many<n>visitors as we have subscribers? Answer: People are coming to our "front<n>porch"--the small sample of<n>	#journal#	journal_ArticleIP_2240.txt
legality. We don't know exactly why this happened, but it's a good bet that it<n>had something to do with the pressure coming from the White House to raise<n>extraordinary amounts of money for the upcoming 1996 race. The culture of<n>	#journal#	journal_ArticleIP_2251.txt
from transparent falsehood (by leaving it meaningless). But the implicit<n>comparison to Watergate is a shoddy historical absurdity, coming from Mr.<n>Intellectual Standards.<n>	#journal#	journal_ArticleIP_2256.txt
bill headed toward overwhelming passage in the Senate, however, political<n>reality began to assert itself. With an election coming up, the last thing the<n>Clintonites wanted was to get on the wrong side of a potentially explosive<n>	#journal#	journal_ArticleIP_2257.txt
The final<n>step is coming up with a pretext for your decision. Tim Johnson of South Dakota<n>used the possibility of Social Security cuts to justify his flip-flop several<n>	#journal#	journal_ArticleIP_2266.txt
Lately<n>the outpouring has been especially torrential. In addition to the spin coming<n>from the president ("The Lincoln Bedroom was never sold") and the vice<n>	#journal#	journal_ArticleIP_2267.txt
House briefing, Davis was asked whether "access" had been sold to contributors.<n>"Of course, people coming to the White House have access to the president by<n>definition, because he's there. But we regard the notion of special access<n>	#journal#	journal_ArticleIP_2267.txt
clearly said that there was absolutely no requirement, no price tag. These were<n>friends and supporters of his coming to his residence." This mirrored the<n>low-spin style of Ron Ziegler, Nixon's spokesman during Watergate . The<n>	#journal#	journal_ArticleIP_2267.txt
Throughout this<n>enthralling tale, one feels a "please don't hit me" cringe coming from the<n>author. Nonetheless, he plunges relentlessly ahead as he details his deep<n>	#journal#	journal_ArticleIP_22748.txt
achievements. Because his crime crackdown has succeeded, further reductions in<n>lawlessness are coming at the cost of increased friction with innocent<n>citizens. Racial hysterics and Dinkins Democrats exploit incidents like the<n>	#journal#	journal_ArticleIP_22752.txt
count on party discipline to reject McCain-Feingold outright, or to use the<n>power of the gavel to prevent it from coming to the floor, would be to court a<n>public backlash and a revolt within the Republican caucus. That kind of<n>	#journal#	journal_ArticleIP_2285.txt
"They deny everything. They essentially say to their very best customers<n>that you get what's coming to you for believing us."-- lawyer William Gaylord<n>refers either to the ad campaign for The Mod Squad that lured hundreds<n>	#journal#	journal_ArticleIP_22897.txt
seem to resent themselves. Just as he gets it from all sides as a member of the<n>'60s generation, Clinton gets it coming and going on the issue of class. To<n>Georgetown sophisticates, there is something hopelessly garish and cheap about<n>	#journal#	journal_ArticleIP_2300.txt
accounts of the operational technique of ethnic cleansing. First the roar of<n>tanks coming down the valleys, then the sound of whistles being blown and the<n>firing of automatic weapons, as the villages and hamlets that dot southern<n>	#journal#	journal_ArticleIP_23059.txt
For over a year, the only<n>real news coming out of the Republican caucus has been gossip about internecine<n>warfare, tales about coups and countercoups, ambition, rebellion, and<n>	#journal#	journal_ArticleIP_2305.txt
plotted to overthrow him and might plot again. I've heard others suggest that<n>he is an undiagnosed manic-depressive coming off a three-year spree. Perhaps<n>the most common view is that Newt is merely positioning for 2000, trying to<n>	#journal#	journal_ArticleIP_2310.txt
limits the terms of its representatives harms itself relative to others. But<n>there is no excuse for McInnis' just coming to grips with these objections.<n>After 10 years in the Colorado House of Representatives, the last two as<n>	#journal#	journal_ArticleIP_2311.txt
who seems faintly disapproving of the lifestyle of the farmer and the seaman,<n>which strikes me as impertinent coming from a ruminant. If two people are<n>happy, where's the harm, Mr. Oh-So-Judgmental Moose! The seal includes a pine<n>	#journal#	journal_ArticleIP_23264.txt
trying to find our place in a bigger picture than the evening news and hoping<n>to see what is coming next.<n>Three kinds of theories of<n>	#journal#	journal_ArticleIP_2356.txt
certain technology. The Roman Empire came to an end, feudalism came to an end,<n>and some say that the Industrial Age is coming to an end. These periods will<n>not come back. There may or may not be common features that bring ages to an<n>	#journal#	journal_ArticleIP_2356.txt
That permits prediction of the remaining duration of the present phase and the<n>coming of the next phase. A simple historical cycle consists of alternating<n>phases of political activism followed by political passivity. Arthur<n>	#journal#	journal_ArticleIP_2356.txt
do, I am reasonably sure that American governments of the 1990s cannot do, nor<n>would I wish it. I merely predict that sometime in the coming generation,<n>profanity will return in a meaningful way. It served too many purposes for too<n>	#journal#	journal_ArticleIP_2373.txt
pool of potential athletes has expanded in other ways, too. First, the<n>population has exploded. Second, we are coming ever closer to a worldwide<n>middle class, the class from which athletes typically are drawn. Whether, in an<n>	#journal#	journal_ArticleIP_2377.txt
shares top billing with a dolphin.<n>The coming plague of animal<n>films is nothing new. The last few years have witnessed Babe<n>	#journal#	journal_ArticleIP_2394.txt
brutal word come out--miscegenation." Coming after a lengthy confession of his<n>tortured feelings toward blacks--and coming at a time when 19 states still had<n>anti-miscegenation statutes on the books--Podhoretz's call for a "wholesale<n>	#journal#	journal_ArticleIP_2398.txt
point will be reached, well into the next century, when the Social Security<n>"trust fund" is exhausted, and not enough money is coming in to pay the<n>currently promised benefits.<n>	#journal#	journal_ArticleIP_2405.txt
would have had better optics. As my wife Sue said: "A large front-end bonus is<n>for coming to the company. That's something positive. But a huge severance<n>package is for failing. And that's incomprehensible." I couldn't have put it<n>	#journal#	journal_ArticleIP_2408.txt
A very pale young man stood<n>up and said that Judgment Day was coming unless the Republic of Texas<n>succeeded. Then he started crying.<n>	#journal#	journal_ArticleIP_2444.txt
low government spending have been curiously silent in response to the new<n>signals coming from the top. Just the other day, Chief Executive-designate Tung<n>Chee-hwa--who will take over from Patten come July 1--sent a very loud official<n>	#journal#	journal_ArticleIP_2449.txt
pursuing the noble goal of academics everywhere--tenure. Certainly tenure was<n>in the bag for these fellows after coming up with the formula, though it<n>probably was likely for them anyway. Or, if not tenure, their goal might have<n>	#journal#	journal_ArticleIP_2477.txt
in which time and space loop around and tie each other in knots. The piece is a<n>surprise coming from someone who has produced many readable scoops.<n>"In the spring of 1995," the story begins (and<n>	#journal#	journal_ArticleIP_2478.txt
the Ozark Exemption, or as the nattering of, in the words of Newsweek 's<n>Evan Thomas, "some sleazy woman with big hair coming out of the trailer<n>parks"--a remark for which he later apologized. It wasn't until Stuart Taylor<n>	#journal#	journal_ArticleIP_2491.txt
The "Benefits" column in<n>Sunday's New York Times listed more than two dozen events coming up this<n>week. A few highlights:<n>	#journal#	journal_ArticleIP_25138.txt
reasonable to assume that they know they will probably lose but are happy to<n>take that chance for 1) the pleasure of playing and 2) the chance of coming out<n>ahead.<n>	#journal#	journal_ArticleIP_2522.txt
with hope running high. Even Jason Hudgins gets to soar. "I look in the mirror<n>and I think to myself: 'Look at the person that you're coming to be.' "<n>It's a little hard to believe that the Jasons<n>	#journal#	journal_ArticleIP_2535.txt
adults might look in the mirror and think to themselves, "Look at the person<n>that you're coming to be." The sight of the inner teen-ager acting out ought to<n>be fairly sobering. (Dick Morris, the man who came up with Clinton's get-tough<n>	#journal#	journal_ArticleIP_2535.txt
late, it said. In Britain, the Times reported that the BBC's world affairs editor, John<n>Simpson, was coming under fierce British government criticism for "Serb bias"<n>in his coverage from Belgrade. "In an astonishing attack, senior officials<n>	#journal#	journal_ArticleIP_25481.txt
English actor speaking in his own accent. The clues are too faint--too<n>understated. I don't feel that I am coming closer to the solution, even after<n>three hours. Maybe I am just not smart enough for a modern British TV detective<n>	#journal#	journal_ArticleIP_2558.txt
coverage, but with little sports coverage, I soon found myself up to about $80<n>a month. Amortizing my fixed costs over 36 months, the whole thing was coming<n>to about $100 a month. Is that a lot or a little? About 5 million families now<n>	#journal#	journal_ArticleIP_2564.txt
channels provided no content to subscribers. That included 28 blank channels,<n>25 channels containing advertising for the system or schedules of coming<n>events, eight channels of broadcast stations generally available free without a<n>	#journal#	journal_ArticleIP_2564.txt
seated her next to me. She was obviously blind, carrying a long white cane and<n>keeping her eyes screwed shut. She could hear the buses coming up to the stop<n>but didn't know which buses they were, so I began telling her their numbers. It<n>	#journal#	journal_ArticleIP_2568.txt
turned out that she was waiting for the bus that I was waiting for, the No. 80.<n>Since she was so anxious about the coming of our bus, I asked her whether she<n>had an appointment. She said that she was going to a class at George Washington<n>	#journal#	journal_ArticleIP_2568.txt
swimming pool, I have seen the senator on his terrace and exchanged a word with<n>him. Two years ago, before the presidential election campaign, I met him coming<n>out of the drugstore and used the occasion to advise him that cutting taxes was<n>	#journal#	journal_ArticleIP_2573.txt
and asked if he had sighted her. He had been there for three days and had not.<n>In fact, I have never seen her on television coming out of the Watergate, but I<n>may just have missed it.<n>	#journal#	journal_ArticleIP_2573.txt
Some of<n>the summer people have been coming to the same small town for so many years,<n>even for more than one generation, that they are part of the local scene and do<n>	#journal#	journal_ArticleIP_2577.txt
the political, economic, and social world we all live in. But so are<n>Philadelphia and Charlottesville, Va. The summer people coming to these small<n>towns are not tourists looking for a civics lesson. They are, it seems to me,<n>	#journal#	journal_ArticleIP_2577.txt
(For more on the Internet controversy about the Hale-Bopp UFO, click .)<n>The spacecraft is coming to<n>transport "us" (whoever "us" might be) back to the "Kingdom of Heaven." This<n>	#journal#	journal_ArticleIP_2583.txt
scare. You'd have thought it would discourage her but, jeez, she just kept<n>coming back. Of course, you'd have thought she'd discourage us, but we kept<n>coming back, too. State law.<n>	#journal#	journal_ArticleIP_25848.txt
coming back. Of course, you'd have thought she'd discourage us, but we kept<n>coming back, too. State law.<n>I'm grateful to Daniel<n>	#journal#	journal_ArticleIP_25848.txt
Kristol is cut off by fellow commentator George<n>Stephanopoulos, who knows where Kristol is coming from and where he is going.<n>Before Kristol can explain why the intern is in the news or identify Matt<n>	#journal#	journal_ArticleIP_2587.txt
enforce its oil embargo against Yugoslavia. In Paris, Le Figaro led on the cost of<n>the war, warning that Europe is coming under pressure from the United States to<n>pay a larger share of it.<n>	#journal#	journal_ArticleIP_26054.txt
are minor variations in the kinds of slot machines you'll find, and casinos are<n>always coming up with mindless variants on the classic table games, but in<n>essence what every gambler is buying is simply opportunity. Or, as a casino CEO<n>	#journal#	journal_ArticleIP_2629.txt
president of Cicero, Ill., wants to fight even harder; she proposes exiling<n>gang members--banishing them from Cicero--and coming down hard if they ever<n>return, even to visit their families. The people of Cicero overwhelmingly<n>	#journal#	journal_ArticleIP_26347.txt
candidates, and Republican troublemakers spin and position and jockey to write<n>the script for the coming real campaign--in this case, a script that makes<n>Bradley a white knight and Gore a looming disaster.<n>	#journal#	journal_ArticleIP_26391.txt
who's been the key spokeswoman for the network for almost five years now. You<n>might have thought that Warwick would have seen this coming two decades ago,<n>when, on the advice of a psychic, she added an "e" to her last name and watched<n>	#journal#	journal_ArticleIP_2641.txt
to stay on the line for as long as possible--though not so long that they run<n>up massive bills they will deny having amassed--and to keep them coming back.<n>As a result, especially in the last few years, the psychic business has tried<n>	#journal#	journal_ArticleIP_2641.txt
Caterpillar's about-face was not sharp enough for the UAW rank and file, which<n>focused not on the 110 who would be coming back to work but on the 50 who would<n>not. As one leader of the opposition to the contract told the Los Angeles<n>	#journal#	journal_ArticleIP_2644.txt
The complete AZT regimen<n>isn't coming . By 2000, 6 million pregnant women in developing nations will<n>carry HIV. Critics are right that a complex AZT regimen would be best for them.<n>	#journal#	journal_ArticleIP_2668.txt
was his energetic, driven self. Friends said he was enthusiastic about his<n>coming assignment to Germany. He spoke of buying a motorcycle there and maybe<n>finding a girl to bring home. He had had girlfriends before, but after three<n>	#journal#	journal_ArticleIP_2669.txt
that studies showed no connection. But my pager went off before I could start.<n>I had a new patient coming in.<n>	#journal#	journal_ArticleIP_2673.txt
Viagra Creep<n>The craziest idea coming<n>out of the Viagra frenzy is that it's somehow scary and wrong for health<n>	#journal#	journal_ArticleIP_2675.txt
Hence Whitehead's argument, repeated in several venues, that the ruling would<n>discourage sexual harassment victims from coming forward. As Buchanan put it,<n>"the boys in the War Room" had "won a little victory today over this little<n>	#journal#	journal_ArticleIP_2700.txt
"jumped out of bed and said, 'I'm not you're wife anymore. I'm leaving you and<n>never coming back.' " On the other hand, perhaps this is a custom of what must<n>be the ever-dwindling band of Yugoslav royals.<n>	#journal#	journal_ArticleIP_2732.txt
is no impact on our culture and our children that is adverse if there is too<n>much violence coming out of what they see and experience," he said. In other<n>words, the issue is the quantity of violence that kids absorb from<n>	#journal#	journal_ArticleIP_28168.txt
time. If they wore wraps, hand them to them. If the weather is too warm, thank<n>them for coming and walk with them to the door. Do not take no for an answer.<n>The socially inept are not kid-glove candidates.<n>	#journal#	journal_ArticleIP_28195.txt
owners tried to sell him for $62,500, but nobody bought him. His jockey in both<n>races, Chris Antley, is coming back from a bout with drug abuse in the late<n>'80s and a weight problem last year. The spins: 1) It's "a fairy tale ride" for<n>	#journal#	journal_ArticleIP_28488.txt
it's a counter-CNN for the disenfranchised, gangsta rap is merely the wheel<n>coming full circle--back to Charles Harris and "After The Ball." If the defense<n>is that 1990s rap is documentary--"the authentic sound of the streets"--well,<n>	#journal#	journal_ArticleIP_2889.txt
him with that other wily courtier, Rasputin, the man behind the czarist throne,<n>who was poisoned, drowned, etc., but managed to keep coming back. (See Boney<n>M's seminal 1979 disco hit, which runs, "Ra-ra-rasputEEN , lover of the<n>	#journal#	journal_ArticleIP_2890.txt
maintain their pose as countercultural revolutionaries, the aristrockracy is<n>finally coming out of the closet. To his credit, though, even Mick Jagger feels<n>the trend toward rock respectability is going too far. Recently, he dropped in<n>	#journal#	journal_ArticleIP_2894.txt
all, and that fanciest chord was there long before Hammerstein fixed the words<n>to those notes. It's possible that Hammerstein, coming upon "the lowest note of<n>the phrase," thought, "Hey, I'll write 'upstream' there. How's that for a<n>	#journal#	journal_ArticleIP_2896.txt
Still, you can't blame Block<n>for trying. He's coming at it from the conservatory end of things and, if<n>you're used to opera, the union of words and music in American song must take<n>	#journal#	journal_ArticleIP_2896.txt
to use dramatically. "Well, I don't think it's difficult," retorts<n>Simon. "But the people who were trying to write it weren't coming from rock 'n'<n>roll--they were doing an impression of rock 'n' roll. And, since<n>	#journal#	journal_ArticleIP_2897.txt
Chicago, earning his living as a janitor in a hospital during the day, going to<n>Mass frequently, and coming home at night to work on his paintings and his<n>writing. He was born in 1892, sent to a Catholic boys home at 8, and then<n>	#journal#	journal_ArticleIP_2911.txt
drapery of canvas ( Package on a Table , 1961).<n>We're meant to feel that we're coming to the end of the<n>line, an impression confirmed in Domenico Gnoli's painting of an empty table<n>	#journal#	journal_ArticleIP_2915.txt
I am surrounded by exercise nuts, both in my<n>family and at work. Almost everybody I know is either coming from or going to<n>the gym. I am a size 10, feel fit, and make it my business to walk wherever I<n>	#journal#	journal_ArticleIP_29226.txt
interracial violence and graphic, near-surrealist detailing to provide the<n>reader an ironic, ambiguous tale of a white boy, a moral innocent, coming of<n>age. "A Hard Time Keeping Up" is very much a Chester Himes-type of hard-boiled<n>	#journal#	journal_ArticleIP_2943.txt
Partly it was a belief, hard to remember today, that a superior new society was<n>already coming into existence. And it was the belief that we ourselves--the<n>teenage revolutionaries, freaks, hippies and students--stood at the heart of a<n>	#journal#	journal_ArticleIP_2947.txt
Of course, that means<n>coming up with guidelines that preserve the moral purpose of humanitarian aid<n>and intervention while addressing Maren's critique. In The Ethics and<n>	#journal#	journal_ArticleIP_2958.txt
life among the silverbacks: "Did they think of me? I thought of them. ... It<n>was terrifying and wonderful ... I was coming back to something I had lost a<n>long time ago and was only now remembering." Danny Elfman puts a swelling choir<n>	#journal#	journal_ArticleIP_29745.txt
make the couple's alienation palpable.<n>Nic's wife dreams of coming upon Nic in a jazz<n>combo, then dancing half-naked for old people; Nic dreams of being dogged at a<n>	#journal#	journal_ArticleIP_29745.txt
Private Matters: In Defense of the Personal Life , in which she says<n>that, coming across a sexual scene in one of her father's novels, she put the<n>book down in embarrassment, out of daughterly modesty. But even a nondaughter<n>	#journal#	journal_ArticleIP_3010.txt
white supremacist pigmentocracy. Hence the despairing talk about "the<n>permanence of racism," "the myth of black progress," and "the coming race<n>war."<n>	#journal#	journal_ArticleIP_3014.txt
has been accused of avoiding politics when he writes. That's a mystifying<n>charge: Biswas' paranoias, the magistrate's coming apart in Coetzee's<n>Waiting for the Barbarians , the antihero's inability to connect with the<n>	#journal#	journal_ArticleIP_3015.txt
stuff taking on such giant conspiracies--and frightening too. Can Ruddy be sure<n>the men with orange vests won't soon be coming for him?<n>	#journal#	journal_ArticleIP_3016.txt
"We've<n>traced the call ... it's coming from inside the house."-- Daniel Radosh<n>and Floyd Elliot<n>	#journal#	journal_ArticleIP_30233.txt
of them targeting white-Asian unions along with white-black ones. Only in the<n>North did laws against intermarriage draw real fire, coming off the books in<n>Maine, Michigan, Ohio, and Rhode Island.<n>	#journal#	journal_ArticleIP_30352.txt
have been posthumously published in the last few years ( Scum , The<n>Certificate , Meshugah ) that death is coming to seem like just<n>another problem of translation for the great Yiddish writer. But Singer, who<n>	#journal#	journal_ArticleIP_3037.txt
side to Switzerland that is very generous, giving millions to refugees, and a<n>stricter side that wants to make sure that people coming in are not<n>____________."<n>	#journal#	journal_ArticleIP_30471.txt
millions to refugees, and a stricter side that wants to make sure that people<n>coming in are not ____________."<n>"Er,<n>	#journal#	journal_ArticleIP_30565.txt
Answer<n>The Swiss want to make sure people coming in are<n>not abusing the law.<n>	#journal#	journal_ArticleIP_30565.txt
coach, refers either to the stoning of Michael Eisner at halftime during the<n>NBA finals or to Michael Jordan coming out of retirement yet again.<n>"Customer expectations will drive changes in vehicles if that's what<n>	#journal#	journal_ArticleIP_30725.txt
Rosenbaum's straight-faced attempts to lay out the rival theories of Hitler<n>Studies one by one. He has a way of coming up with a quick summary of complex<n>proposals that clarifies and nullifies them in one stroke. For example, he<n>	#journal#	journal_ArticleIP_3073.txt
Le Monde 's editorial also deplored the timing of the minister's<n>statement, coming just as NATO is discovering that its worst fears about Serb<n>atrocities were justified and that the accounts by Kosovar refugees were not<n>	#journal#	journal_ArticleIP_30775.txt
possible future leader of the province, said it reached him by telephone and<n>was told that he is fine and will soon be coming out of hiding. The<n>Guardian ran an article by former Soviet leader Mikhail Gorbachev about<n>	#journal#	journal_ArticleIP_30775.txt
different treatment; the Op. 2 sonatas, for example, don't need a sound source<n>identical to the Hammerklavier . And the coming original-instrument<n>performances of the remaining concertos from Levin and Gardiner promise to be<n>	#journal#	journal_ArticleIP_3081.txt
the sloping shoulder was the noticeable feature of the new clothes of the Dior<n>era, coming as it did immediately in the wake of the Joan Crawford/Rosalind<n>Russell period and its vigorous shoulder padding. Garbo's characteristic<n>	#journal#	journal_ArticleIP_3092.txt
page has also looked as indispensable as the adaptable dress of modern thought,<n>but we can't predict thought-fashion for the coming centuries. Maybe the<n>anti-fashion people now wearing pale blue and muted rose are dressing to match<n>	#journal#	journal_ArticleIP_3096.txt
The death of haute<n>couture is a constant refrain of fashion critics. It has been coming to an<n>end ever since it started, much like culture in general. What a killing blow<n>	#journal#	journal_ArticleIP_3100.txt
Kosovo update: 1) Thousands of Serbs rallied for Slobodan Milosevic's<n>resignation. More protests are scheduled in coming weeks. 2) Ethnic Albanians<n>continued to loot and torch Serb villages. Kosovar Serbs continued to flee. 3)<n>	#journal#	journal_ArticleIP_31242.txt
The decline of the big band<n>was belabored and cartoonish; it kept coming back long after it seemed to have<n>drawn its last breath. World War II is what really did it in, since the gas and<n>	#journal#	journal_ArticleIP_3157.txt
training have been?<n>But coming up with the right answer to a question like,<n>"Why Are Harvard Law Students Unhappy?" should not tax the analytical skills<n>	#journal#	journal_ArticleIP_31664.txt
point: Snow's street-by-street tracking of cholera deaths pointed unmistakably<n>to the culprit--the water coming out of the Broad Street pump. The pump handle<n>was removed at once, and the epidemic ceased.<n>	#journal#	journal_ArticleIP_3172.txt
hard never made it onto this original list--a significant omission,<n>given the prominence they are coming to enjoy in the public arena of<n>language.<n>	#journal#	journal_ArticleIP_3176.txt
but it added: "The sense that there is no rush is something of a facade. In<n>fact, time is of the essence. The coming year is crucial for both Barak and<n>Clinton."<n>	#journal#	journal_ArticleIP_31989.txt
and was ostracized by Christian conservatives. This year, Forbes has made up<n>with these conservatives, largely by coming out against legal abortion. He<n>seems just as uncomfortable railing against abortion in this election as he was<n>	#journal#	journal_ArticleIP_32147.txt
the bum luck to land on a prison transport flight described--in one of those<n>testosterone-laden lines that can be comfortably transplanted to coming<n>attractions--as "a planeload of pure predators." These include serial killers,<n>	#journal#	journal_ArticleIP_3221.txt
say that Batman & Robin is a punishing ordeal, I want you to know<n>where I'm coming from. I have an appetite for Hollywood blockbusters of the<n>sort that some literate people consider big and dumb. I thought the first<n>	#journal#	journal_ArticleIP_3222.txt
might be the work of the brilliant cinematographer (Darius Khondji, of<n>Seven ) or--Weaver being Weaver--might just be coming from within.<n>	#journal#	journal_ArticleIP_3238.txt
effort. Back in 1983, he made an oddity called Angelo My Love , a<n>semi-improvised account of a boy coming of age among the gypsies. Watching that<n>movie, I found myself simultaneously attracted to and repulsed by the<n>	#journal#	journal_ArticleIP_3243.txt
Johnny, I Hardly Knew Ye<n>There will be a lot written in the coming days and<n>months by people who didn't really know John Kennedy. Those of us who had the<n>	#journal#	journal_ArticleIP_32532.txt
begins to babble the truth on the stump, the film has a kamikaze comic spirit<n>that's spectacularly disarming, particularly coming from its hitherto<n>overcautious auteur--not to mention a major studio owned by right-of-Attila<n>	#journal#	journal_ArticleIP_3253.txt
balance to strike when it's common for Americans to eat double the protein we<n>need, with 70 percent of it coming from animal sources.<n>Could there be some other dietary factor at work as well?<n>	#journal#	journal_ArticleIP_32621.txt
as his are not more widely known because, "Unfortunately, we are absolutely<n>drowned in information coming out of the dairy industry. ... Our national<n>nutrition policies are corrupted by the influence of the dairy industry."<n>	#journal#	journal_ArticleIP_32621.txt
to become a cause<n>célèbre --and to be coming soon to a theater<n>near you. It's always nice to see distributors proved wrong about the merits of<n>	#journal#	journal_ArticleIP_3262.txt
heedless of the proper limits of power, unable to plead guilty to anything much<n>worse than 'screwing up' and coming no closer in history to that final<n>absolution in history he seeks."<n>	#journal#	journal_ArticleIP_32927.txt
$1.25 billion. And its future is even better. Marketing consultant Burt<n>Flickinger sees something coming that is "the best possible thing that can<n>happen to Wal-Mart and the worst thing that could happen to every major<n>	#journal#	journal_ArticleIP_33088.txt
percent and profits up 21 percent to $1.25 billion. And its future is even<n>better. Marketing consultant Burt Flickinger sees something coming that is "the<n>best possible thing that can happen to Wal-Mart and the worst thing that could<n>	#journal#	journal_ArticleIP_33149.txt
attorney, but if this isn't overtly promoting infanticide as a form of<n>population control, it's coming awfully close. Crawl, little baby! Crawl for<n>your life!<n>	#journal#	journal_ArticleIP_33149.txt
forecaster announces that a cold front is "descending" from Canada--as if some<n>malevolent Arctic god were coming to exact revenge for the sins of<n>Washington.<n>	#journal#	journal_ArticleIP_3325.txt
is like following baseball by reading scorecards. The weather forecast is more<n>than "rain." You must also hear the story of the rain. Where is it coming from?<n>Whose fault is it? Canada's? The Great Lakes'? The Bermuda High's? What kind of<n>	#journal#	journal_ArticleIP_3325.txt
It's tempting to dismiss<n>the whole industry as a scam, particularly when dentists keep coming up with<n>new ailments such as bruxism (teeth grinding), periodontal disease,<n>	#journal#	journal_ArticleIP_33269.txt
D)<n>"The Dance": Nash lies and promises everyone that Davy Jones will be coming to<n>the school dance; at the last minute, Davy shows up to save the day. (Special<n>	#journal#	journal_ArticleIP_33763.txt
Because the barbarians are<n>coming today.   What's the point of senators making laws now?   Once the<n>barbarians are here, they'll do the legislating.<n>	#journal#	journal_ArticleIP_3383.txt
Because the barbarians are<n>coming today   and the emperor's waiting to receive their leader.   He's even<n>got a scroll to give him,   loaded with titles, with imposing names.<n>	#journal#	journal_ArticleIP_3383.txt
Because the barbarians are<n>coming today   and things like that dazzle the barbarians.<n>Why don't our distinguished<n>	#journal#	journal_ArticleIP_3383.txt
Because the barbarians are<n>coming today   and they're bored by rhetoric and public speaking.<n>Why this sudden bewilderment,<n>	#journal#	journal_ArticleIP_3383.txt
Slate<n>, as he gives us a look at the coming elections.<n>Mike will discuss the impact of the Internet on candidates' campaigns and how<n>	#journal#	journal_ArticleIP_34007.txt
Mark your calendars now,<n>because coming up every other Wednesday evening at 6:00 p.m. PT, you can chat<n>with other notable<n>	#journal#	journal_ArticleIP_34007.txt
A little bent out of shape<n>& leery of the wayThe night was coming down so black along the streets<n>I just knew I couldn't go<n>	#journal#	journal_ArticleIP_3400.txt
The<n>words coming out of the Middle East these days are as revolutionary as the<n>deeds. Barak and his deputies are not merely changing Israel's policy toward<n>	#journal#	journal_ArticleIP_34377.txt
the abstract of a mountain range<n>or large waves coming in,<n>repeated and repeated and repeated--<n>	#journal#	journal_ArticleIP_3439.txt
will come to seem eternal and inevitable will actually be invented in the<n>coming months.<n>Net<n>	#journal#	journal_ArticleIP_34450.txt
appeared a short distance away, heading toward his limo. He saw the press and,<n>for a moment, seemed to be coming toward us. Then he stopped, and just stared.<n>One could imagine that he felt a little hurt when he realized that we didn't<n>	#journal#	journal_ArticleIP_3486.txt
baby," Gardi said. A farm employee warned her to be prepared for what was<n>coming up: "It is a little ..."--the employee paused--"violent."<n>Everyone at the farm was wary of Canada Miss.<n>	#journal#	journal_ArticleIP_3487.txt
anticipation of spring. They take spring gardening catalogs with them into the<n>tub, where they plan their coming glories. They start seeds in their basements<n>to get a jump on the season. I was not ready to go there yet. Instead, quite by<n>	#journal#	journal_ArticleIP_3494.txt
Stadium), then it's back to the game for more nail-biting at bats. But pretty<n>soon the relationship flashbacks start coming thick and fast, and the balance<n>of the movie shifts to whether Kevin can commit to Kelly and Kelly can commit<n>	#journal#	journal_ArticleIP_35005.txt
East Timor is already seriously straining the country's defense budget, called<n>for a large increase in its defense capability. "One message coming loud and<n>clear out of the recent flurry of diplomatic activity over a peacekeeping force<n>	#journal#	journal_ArticleIP_35072.txt
Saint-Saëns, for piano and voice, with 11 of the 27 songs from poems by<n>Hugo. Which is to say, Victor Hugo, rendered into music, is coming at us from<n>three directions today, triophonically, so to speak--as a Broadway<n>	#journal#	journal_ArticleIP_3524.txt
In the past, when<n>escorting a young woman to my automobile after, say, coming out of a<n>restaurant, I would unlock the passenger-side door for her first before walking<n>	#journal#	journal_ArticleIP_3535.txt
concealed handguns, is in danger of completing this reversal. By fighting crime<n>with "love," he is coming across not as a gun nut, but as a wimp.<n>Bush<n>	#journal#	journal_ArticleIP_35371.txt
Slate readers, however, Prudence has prevailed upon her niece and<n>namesake, Prudence, to assume the responsibility. In coming weeks, Prudie (as<n>she is known to friends) will begin to respond to some of the unanswered<n>	#journal#	journal_ArticleIP_3547.txt
Slate readers, however, Prudence has prevailed upon her niece and<n>namesake, Prudence, to assume the responsibility. In coming weeks, Prudie (as<n>she is known to friends) will begin to respond to some of the unanswered<n>	#journal#	journal_ArticleIP_3548.txt
I'm<n>curious about your thoughts on the coming millennium change and the notion that<n>the world, due to its reliance on computers in things like tax collection and<n>	#journal#	journal_ArticleIP_3550.txt
that God forgives little white lies when they are intended to spare someone's<n>feelings. Prudie believes this approach preferable to coming right out with<n>your "happy clappy" concerns, if I understand them. I am guessing our<n>	#journal#	journal_ArticleIP_3550.txt
dreaded topic of roommates. My roommate, just in the last two weeks, has<n>developed a habit of going out and coming in late. I'm a light sleeper, and<n>I've been suffering from her nocturnal excursions. We had decided (before these<n>	#journal#	journal_ArticleIP_3551.txt
Indonesia has bottomed out. In general, the market panic of 1997-98 was, it<n>turns out, coming to an end just about the time that Malaysia decided to make<n>its big break with orthodoxy. You can argue that the controls may have allowed<n>	#journal#	journal_ArticleIP_35534.txt
overly stressed by finals, and the question haunts me: When will the insanity<n>stop? Teachers are asking more of students every year, and it's coming to the<n>point where the average kid has to go to college for four years just to flip<n>	#journal#	journal_ArticleIP_3553.txt
voice asking why your credit-card payment is late, it is probably because the<n>call is coming from India (the operators assume western names and reportedly<n>pick up the twang of the region they cover)."<n>	#journal#	journal_ArticleIP_35569.txt
fixated on an activity that you feel is verboten but which, in fact, is<n>normal. But do not feel that your wheels are coming off. You are, after all,<n>only 18, and beginning to tackle the problem will surely ease the situation. As<n>	#journal#	journal_ArticleIP_3565.txt
have a very nice friendship, and I can't figure out where your new ,<n>unfriendly remarks are coming from. Perhaps I am misunderstanding you. It has<n>always meant so much to (insert husband/father's name) that the social<n>	#journal#	journal_ArticleIP_3567.txt
festering that make her mean. (Prudie, for example, could use directions more<n>often than not, and coming from a loving partner they would cause no<n>irritation.) Your herding her around suggests that you are compensating, in the<n>	#journal#	journal_ArticleIP_3569.txt
commerce clause, which facilitated the creation of a national economy. Judges<n>are increasingly coming to this view. At the very least, it means that the<n>restrictions do not have the halo of constitutional protection.<n>	#journal#	journal_ArticleIP_35790.txt
actually decreased slightly in 1991. The census pattern suggests that slightly<n>more interracial couples will fall into each other's arms in the coming years<n>but that there will be nothing resembling a dramatic acceleration of marriage<n>	#journal#	journal_ArticleIP_35817.txt
black ancestry within the last four generations. He predicted that the<n>proportion would only grow in the coming decades. The belief that one's<n>ancestors are "racially uniform" is a basic American fiction, Stuckert wrote,<n>	#journal#	journal_ArticleIP_35817.txt
remembered to order some in the fall. Last week, in San Francisco, I saw it<n>coming up in a pleasing manner from between the stones of a garden path.<n>I set aside some of my own bulbs last fall,<n>	#journal#	journal_ArticleIP_3589.txt
case of national differences between U.K. and U.S. neo-conceptualism. You are<n>quite right that the Brits are dead against coming over as theoretically<n>highbrow. If anything, they veer in the opposite direction--"dumb enough to be<n>	#journal#	journal_ArticleIP_36005.txt
that it is Whiteread's masterpiece (better than her short-lived House<n>and the West Broadway watertower), but I'm coming round to realizing that it is<n>a masterpiece on any terms. So, I must say I'm grateful to Mr. Saatchi for<n>	#journal#	journal_ArticleIP_36127.txt
They all have a work-in-progress, school-project attitude. Most don't open<n>until 1 o'clock, if then, and they close whenever people stop coming in. On<n>nice afternoons, friends drop in on their bicycles to say hello and examine the<n>	#journal#	journal_ArticleIP_3618.txt
mismanagement that has resulted in the British Royal Opera closing down for the<n>coming season is less likely when managers have to raise the money<n>themselves.<n>	#journal#	journal_ArticleIP_3620.txt
General Electric knows how to make a light bulb last 1,000 years but suppresses<n>the technology to keep us coming back for more light bulbs. Likewise, Ann<n>Landers is forever publishing columns about how pantyhose are intentionally<n>	#journal#	journal_ArticleIP_36534.txt
challenge, it has supplanted his message as the campaign's hot story. Every<n>headline coming out of the Iowa dinner focused on Gore's challenge and ignored<n>Bradley's good speech.<n>	#journal#	journal_ArticleIP_36546.txt
and she knows that.) We are both in similar financial situations, and I felt<n>cheated. Her birthday is coming up soon. Should I take her out again, or just<n>give her a small gift and forget our tradition of the birthday dinner?<n>	#journal#	journal_ArticleIP_36584.txt
of India reported "growing disquiet" among Indian officials about<n>the prospect of a nuclear Pakistan being controlled by a general. "A coming<n>together of the hardline army and religious right-wing political groups may be<n>	#journal#	journal_ArticleIP_36598.txt
Tokyo completes the list in ascending order of the<n>world's five largest metropolitan areas, coming in with more than 28 million<n>people.<n>	#journal#	journal_ArticleIP_36789.txt
Jörg Haider led his far-right Freedom Party to a stunning second-place finish<n>in Austria's national elections; two weeks from now, he's coming to America. To<n>do what?<n>	#journal#	journal_ArticleIP_38046.txt
to slam a competitor via the most unprofessional means. The kind of SLATE I was<n>coming to enjoy reading was one that would rip the Wall Street Journal<n>apart using facts, ideas, and finely honed reasoning. There is no place in that<n>	#journal#	journal_ArticleIP_3835.txt
crime is going for market share, rather than creating a new market. This is not<n>strange, coming from Microsoft. If only you had the slightest notion of how<n>demented the idea of Microsoft pushing the Internet is. Buy an upgrade for your<n>	#journal#	journal_ArticleIP_3835.txt
of the masses for our elite readership."<n>Hopefully, your coming music criticism won't be so pedantic or derisive--or so<n>simplistic and misguided: To imply that Coolio's "Gangsta's Paradise" is<n>	#journal#	journal_ArticleIP_3845.txt
suggests. Rather it may serve to delay the conception of a rival for maternal<n>resources--both directly (by literally coming between Mom and Dad) and<n>indirectly (by tending to prolong breast-feeding and, therefore, to suppress<n>	#journal#	journal_ArticleIP_3860.txt
stunning second-place finish in Austria's national elections; two weeks from<n>now, he's coming to America. To do what?<n>"To<n>	#journal#	journal_ArticleIP_38810.txt
"the Internet just adds ... a layer that it makes it even more difficult to<n>scrutinize where the eggs are coming from."<n>14. Egg buyers will reap unintended consequences.<n>	#journal#	journal_ArticleIP_38823.txt
developing around Cuba, too. If it's sex you must talk about, talk about the<n>pope standing on an island and coming out against birth control (again).<n>Even if there were no other<n>	#journal#	journal_ArticleIP_3900.txt
that many people commonly use the term papal bull to describe almost any<n>document coming from the Holy See, but you are<n>Slate<n>	#journal#	journal_ArticleIP_3907.txt
in the GDP if the shot is on network television. You see, no one pays<n>for network television: No one spends money to see Lewinsky coming out of the<n>Watergate.<n>	#journal#	journal_ArticleIP_3911.txt
to indulge his personal preferences. Perhaps he'll utter a little grumble of<n>dissatisfaction, like all those grumbles coming from Mac users being forced to<n>switch to Windows to be compatible. In the meantime, he has probably paid for<n>	#journal#	journal_ArticleIP_3912.txt
concerning Linda Tripp, "I have to stick by my observation that people, for<n>better or for worse, grow into their appearance, coming to look on the outside<n>as they feel on the inside."<n>	#journal#	journal_ArticleIP_3922.txt
looked down upon is anti-American at best. I am happy that people of faith are<n>finally coming out of the closet, so to speak. Articles like this one invite<n>reactionism, which is, I suppose, what the writer wants. Too bad.<n>	#journal#	journal_ArticleIP_3923.txt
them. (I didn't even say who the villain was, although it's so obvious--and is<n>even in the coming attractions!--as many critics have.) And if I think that the<n>ending is a major dud and DON'T say so in print, then as a critic I've been<n>	#journal#	journal_ArticleIP_3926.txt
end, the lines had been drawn, with two opposing camps staking out their turf<n>and even coming up with labels for their positions. The Bi-Directionalists<n>believe that language influences culture even as culture influences language;<n>	#journal#	journal_ArticleIP_3948.txt
to happen to us, or to me?' "<n>Is the "top God"-"my God" synthesis coming<n>undone? Even as a great deal of the "top God" discussion drifts into remote<n>	#journal#	journal_ArticleIP_4069.txt
'stake, see Robert Wright's ".") ... A piece marvels<n>at the coming wave of young, democracy-minded Iranians. The population has<n>doubled since the 1979 revolution, and in 10 years Iranians under 30 will<n>	#journal#	journal_ArticleIP_44158.txt
which she single-handedly "retrieve[s] [the] secret struggle for womanhood" by<n>narrating her own sexual coming of age. "By telling my story and asking other<n>women to tell theirs, I wanted to elucidate the emotional truths that emerge<n>	#journal#	journal_ArticleIP_45652.txt
from a particular generation's erotic memory," she explains. She bills her<n>stories as tough to tell: In a Tikkun magazine piece on her coming out<n>as a spiritual person, she testifies that "it's taken me nine years to build up<n>	#journal#	journal_ArticleIP_45652.txt
damage. It's the scene in a posh restaurant in which Wallace regards the<n>Wigands' paroxysms of fear over the coming 60 Minutes interview with<n>aristocratic contempt. He says, "Who are these people?"--which opens the<n>	#journal#	journal_ArticleIP_45690.txt
amazement, got ready to draw his pistol. "You've got the wrong guy," I said.<n>"I'm just coming home from a business trip." "Shut up," he said. As he barked<n>instructions--keep your hands in the air, spread your legs -- I felt<n>	#journal#	journal_ArticleIP_45728.txt
ration them? More than anything, the current HMO troubles are evidence that<n>this could be the major domestic policy debate of the coming decade.<n>	#journal#	journal_ArticleIP_5099.txt
best intentions to keep in touch and how the new technology might help. Then he<n>thanked everyone for coming to his "press conference."<n>Clinton is right that his successor, , will have a real tool to maintain<n>	#journal#	journal_ArticleIP_52615.txt
biology, or you can make the counter-argument that you can see intelligence<n>coming down the pike from many millions of years in advance. On that issue<n>hinges the abundance of intelligent life in the universe.<n>	#journal#	journal_ArticleIP_56021.txt
can save all over again with these pre-collected nails.<n>BASS FISHING MONOPOLY; GOLF MONOPOLY-- coming soon, Substandard Nursing<n>Home Monopoly, Constant Joint Pain Monopoly, Gradual Loss of Memory<n>	#journal#	journal_ArticleIP_56070.txt
turned on by blacks because blacks are so unbuttoned--because they shake,<n>rattle, and roll? (Ditto.) Is he saying that coming of age as a Jew means<n>learning to embrace both chocolate and vanilla?<n>	#journal#	journal_ArticleIP_56558.txt
Gore adviser, Brown said: "The savage fury against Wolf is the most sinister<n>example of the anti-feminist sexism that will dominate the coming elections. …<n>I think it is only a foretaste of the pseudo-political perfidy that awaits us<n>	#journal#	journal_ArticleIP_57067.txt
don't know if he's cheating on me, but he has been acting strangely. He's been<n>coming home at 6 a.m. when he gets out of work at 1:30 in the morning. He tells<n>me it's because he goes to have coffee with his boss after they close the store<n>	#journal#	journal_ArticleIP_57338.txt
ways. "An anti-abortion group picketed Parliament Buildings, evidence that<n>politics were coming home at last," it said.<n>The<n>	#journal#	journal_ArticleIP_57400.txt
Hogsten tell the story.<n>"As Hurricane Floyd was coming our way, I booked a<n>room near Atlanta, so we could get the heck out of here," the aggrieved Ms.<n>	#journal#	journal_ArticleIP_57518.txt
Personally, while I'm glad Hubby is happy, I don't want this dead thing<n>coming between us.<n>--JEB in Pa.<n>	#journal#	journal_ArticleIP_5978.txt
leads a group of laughing tots into the death chamber. The picture reportedly<n>ended with a shot of black smoke coming out of the stack--but we'll never know<n>because The Day the Clown Cried was judged too obscene to be released,<n>	#journal#	journal_ArticleIP_6285.txt
browse upcoming events, locate your favorite stores in our store directory,<n>shop online or find products before coming to the mall."<n>By consolidating options<n>	#journal#	journal_ArticleIP_65323.txt
e-mail!--that he was planning to divorce my mother and had contacted a lawyer.<n>Now he tells us he's coming home for Christmas. At the same time, my mother<n>invited a friend of hers for Christmas dinner because the woman recently<n>	#journal#	journal_ArticleIP_66951.txt
behind noncomittal words such as "cost estimates" and "weighted averages." You<n>wonder whether he could win a general election coming out of the right lane of<n>the Democratic Party. But first he has to get the Democratic nomination, a race<n>	#journal#	journal_ArticleIP_66966.txt
is that acoustic tile, anyway?) One of the phrases on poor Aquinas' body is<n>"Christ in New York," which Jericho, coming upon the corpse shortly thereafter,<n>quickly deciphers to mean "Christine York," the name of the mother-to-be. Two<n>	#journal#	journal_ArticleIP_66982.txt
terrorism is just one small example.<n>But cheer up! The coming globalization of fear isn't<n>entirely regrettable. It could actually make us, in a sense, better people,<n>	#journal#	journal_ArticleIP_68014.txt
The<n>cover story celebrates the coming of world government. Political<n>globalization is catching up to economic globalization, as evidenced by the<n>	#journal#	journal_ArticleIP_68140.txt
says that minor Y2K inconveniences may pile up<n>in the coming months, especially among small businesses. It also warns that<n>many computers may crash on Feb. 29, a peculiar leap day. (Usually, years that<n>	#journal#	journal_ArticleIP_68140.txt
applied, and the meat actually will come off the executee's bone like the meat<n>coming off a cooked chicken." Leuchter set about making capital punishment more<n>"humane." He moves on to talking about his redesigns for lethal-injection<n>	#journal#	journal_ArticleIP_68313.txt
one of McCain's campaign donors. McCain tries to change the subject to Bush:<n>"Our money is coming in very well, by the way. Not anywhere near $74 million,<n>but it's coming along pretty good." The implicit message of this quip is, "If<n>	#journal#	journal_ArticleIP_68393.txt
"Our money is coming in very well, by the way. Not anywhere near $74 million,<n>but it's coming along pretty good." The implicit message of this quip is, "If<n>you want to look at somebody's fund raising, look at Bush's." McCain delivers<n>	#journal#	journal_ArticleIP_68393.txt
get a better picture, will you?" Everyone laughs. McCain grins again, adding,<n>"And ask him at least to disclose where this money is coming from."<n>Notice<n>	#journal#	journal_ArticleIP_68393.txt
campaign-finance laws, McCain tells Bush to ask his supporter where the ad<n>campaign's "money is coming from." Another point to McCain for landing a second<n>blow and leaving 'em laughing.<n>	#journal#	journal_ArticleIP_68393.txt
Seinfeld. This is the lesson learned by Broadway theater heir, Eric<n>Nederlander, 32, when a week after coming back to New York from a honeymoon in<n>Italy, his new wife Jessica Sklar, 26, met Seinfeld, 44, at the Reebok Sports<n>	#journal#	journal_ArticleIP_7109.txt
can't easily brush off rumors of plots. "One still can't escape the feeling<n>that Microsoft knows something is coming and is positioning itself," said a<n>CNNfn correspondent the day of the handover, alluding to a hypothetical<n>	#journal#	journal_ArticleIP_73373.txt
But in the last year, the two elites have finally realized<n>they need each other. Most of the rapprochement is coming from the Washington<n>establishment, which now understands that the Northern Virginians have ungodly<n>	#journal#	journal_ArticleIP_73434.txt
says Warner. "In the '80s they came because they wanted to have power and make<n>a good living as a lobbyist or lawyer. Now they are coming because they want to<n>do an IPO." After all, influence is hard to measure. Equity isn't.<n>	#journal#	journal_ArticleIP_73434.txt
moment to spare on self-pity. By now there is the most unbelievable ruckus<n>coming from outside. The dog, somehow already possessed of a French dog's sense<n>of her rights, is busy breaking down the door with her head. Sometimes, for<n>	#journal#	journal_ArticleIP_73614.txt
Newvoter.com hasn't brought its service to the market yet, or even settled on<n>its exact business plan-Strama says a "big announcement" is coming soon-but the<n>company plans to sell its service to grass-roots political organizations and<n>	#journal#	journal_ArticleIP_73735.txt
doesn't want the federal government to bother it. People expect the government<n>to keep the Social Security checks and highway money coming and run the courts<n>and stuff like that. But sweeping reforms--even when they really would be<n>	#journal#	journal_ArticleIP_7706.txt
that's all signifiers. I sometimes found myself wishing he would let the<n>picture catch its breath, that the performers would stop coming at me in<n>stroboscopic flashes. But then I'd be swept up in the sinuous motion of his<n>	#journal#	journal_ArticleIP_8112.txt
who was bound to find larger signals gross and yet to<n>miss nuances altogether, coming across as deaf, dumb,<n>and functionally illiterate.  A final instance will make<n>	#journal#	journal_VOL15_1.txt
or Heroine), Smack, and Coke, (though we can be<n>sure that the company coming up with the last of these<n>will hear from you-know-who).  Grass, on the other<n>	#journal#	journal_VOL15_1.txt
for the vicissitudes of poetic fame.<n>Back in 1931, however, when Bodenheim was coming<n>into his own as a literary maverick, New York publisher<n>	#journal#	journal_VOL15_2.txt
On reflection is a flag to indicate that parts is to be<n>read backwards.  Other inversion flags are coming<n>back, returning , and going West .  Purists admit these<n>	#journal#	journal_VOL15_4.txt
never had a major problem until recently.  The timing gear<n>broke in the front yard after coming home from the orthodontist.”<n>[From the Letters column, Friends , .<n>	#journal#	journal_VOL15_4.txt
class, RP speakers, by consent that could<n>scarcely be tacit, change the rules of the game, coming<n>up with shootin' and huntin'.  For example, American<n>	#journal#	journal_VOL16_1.txt
Algonquian word meaning `garlic field.'  It is further<n>pointed out that words coming from Indian languages<n>frequently undergo semantic change:<n>	#journal#	journal_VOL16_1.txt
Iceland in hopes of discouraging immigrants from<n>coming to what is actually a relatively warm and comfortable<n>place to live, since it is heated by geothermal<n>	#journal#	journal_VOL16_1.txt
brightness was as the light; he had horns [rays of light]<n>coming out of his hand [not his head!].  That was<n>about 1400 years ago.  Now the horns are traditional.<n>	#journal#	journal_VOL16_2.txt
had a major problem until recently.  The timing gear broke in the<n>front yard after coming home from the orthodontist.”  [From the<n>Letters column, Friends , .  Submitted by ]<n>	#journal#	journal_VOL16_3.txt
“Oh,” Sissy answered with a certain irrefutable<n>logic, “you're coming the going way.”<n>I knew she meant I was headed away from our<n>	#journal#	journal_VOL16_3.txt
side of town.  We still refer to a person who is lost,<n>either literally or spiritually, as coming the going<n>way .  As one might suspect, this tendency to lose<n>	#journal#	journal_VOL16_3.txt
are owies .<n>Dad would feel as if he were coming the going<n>way on our shopping expeditions, but he manages to<n>	#journal#	journal_VOL16_3.txt
I was pleased to see that Beale accepts the etymology<n>of (British) po-faced as coming from po<n>`chamber pot,' disagreeing with Collins English Dictionary<n>	#journal#	journal_VOL16_3.txt
an acceptable manner.  The CCE does have price to<n>recommend it, coming in at about half of what a college-or<n>desk-sized dictionary would cost.<n>	#journal#	journal_VOL16_3.txt
one to read through a long entry before<n>coming to the sense sought; it is almost impossible to<n>discover where a new part of speech begins; subentries<n>	#journal#	journal_VOL16_3.txt
the new.<n>Non-Southern physicians coming into the South<n>are often puzzled or amazed by the speech of their<n>	#journal#	journal_VOL16_3.txt
hardly scrutinize English publications any more for<n>fear of coming across even more barbaric examples<n>than those we already have--“nuts-crackers,” perhaps,<n>	#journal#	journal_VOL16_4.txt
modifiers.  And what is more, additional ones are<n>coming into use every day.  Hence the recent discovery,<n>by some writers, that it is possible to syllothesize<n>	#journal#	journal_VOL17_1.txt
breeding ground for new drinks.  Very often I would<n>take an order for a drink that was just coming into<n>popularity, and then, when I served the drink, I<n>	#journal#	journal_VOL17_2.txt
only if they come from Truth or Consequences)?  Will<n>they admit to coming from Ding Dong , Texas, Unthanks ,<n>Virginia, Brainy Boro , New Jersey, Mudsock ,<n>	#journal#	journal_VOL17_2.txt
claims “All Natural” and “Fresh” have a similar effect<n>and are also coming under federal scrutiny.  But<n>the investigation should really go beyond the supermarket:<n>	#journal#	journal_VOL18_2.txt
ten to fifteen years.  All the while, of course, just as<n>with all aspects of language, new names are coming<n>into being, others passing out of use, each reflecting<n>	#journal#	journal_VOL18_2.txt
who never heard it before.  When the book was<n>coming out in Black Mask , in 1929, the editor presumably<n>took gunsel to be a synonym of gunman , and<n>	#journal#	journal_VOL18_2.txt
that many of the Bard's words are, even now, lying<n>low awaiting the coming of the inevitable day when<n>they shall become of the bright, new-minted, contemporary<n>	#journal#	journal_VOL18_3.txt
not having much occasion to shout it aloud (the<n>comet coming around only once every 75 years), I<n>formed its pronunciation in my mind and there it<n>	#journal#	journal_VOL19_1.txt
well.  Again, unity and concord.<n>But there is a hazard coming up: It is no use<n>crying over spilt milk (F) Ce qui est fait est fait What<n>	#journal#	journal_VOL19_2.txt
warning Katie, bar the door!  And out of the hills<n>some hill-born singer coming north introduced it<n>there, perhaps directly into the world of sports and<n>	#journal#	journal_VOL19_2.txt
It is certain there will be more and more English<n>words coming into the Chinese vocabulary, and<n>vice-versa.  Chinese has made many contributions to<n>	#journal#	journal_VOL19_3.txt
English, with all thy faults, I loved thee still.  For<n>mine I can imagine him coming up with something<n>like, A good man, apart from his too easy tolerance.<n>	#journal#	journal_VOL19_3.txt
times.  Glowerin ida lum [by the chimney] never<n>filled da pot .  As for time of plenty coming rapidly<n>after scarcity, watch out for Lang want is nae maet<n>	#journal#	journal_VOL19_3.txt
before the prison governor for punishment.<n>After coming in, getting out is the major priority.<n>One counts the days to one's P.E.D. Parole Earliest<n>	#journal#	journal_VOL19_3.txt
what seem to visitors to be odd usages, variations<n>often coming over at first as error; the universal use<n>of the conditional would for the future will can lead<n>	#journal#	journal_VOL19_4.txt
place names has been tending to conform to their<n>written appearance ever since the coming of the<n>railways, and I notice that the letter t is now always<n>	#journal#	journal_VOL21_2.txt
This ambiguity could have extended to Rose ,<n>coming either from the flower or from the Teutonic<n>for horse.  Yet the only male Rose I can discover is<n>	#journal#	journal_VOL22_1.txt
Even nowadays one comes across dialect words<n>whose meaning is obscure.  On coming to live in<n>Gloucestershire, I was puzzled by tump, daps , and<n>	#journal#	journal_VOL22_1.txt
mere cross-section, a sampler of the language of rural<n>America, these coming only from the smallest state.<n>The people who use them use a language far richer<n>	#journal#	journal_VOL22_1.txt
article said, from the Hebrew word for chaos.<n>Can English be far behind?  Announce the coming<n>so that VERBATIM readers can say I know, I know.<n>	#journal#	journal_VOL22_1.txt
They were wheeling away the stretcher to where a<n>cab was coming to take her away from the stadium.  The<n>TV lights were still in Joyner-Kersee's face, the face that<n>	#journal#	journal_VOL22_1.txt
one very misty morning, with a friend from Yorkshire<n>who was coming out on the boat to watch us<n>haul the creaves (lobster pots).  As we neared the<n>	#journal#	journal_VOL22_2.txt
species, some having tenuous associations.  A cater-pillar<n>is the larva of a butterfly or moth, coming<n>from the Old French chate pelouse , hairy cat.  This<n>	#journal#	journal_VOL22_2.txt
Mormons, and conservatives are called iron-rodders ,<n>both terms coming from Book of Mormon images.<n>And finally, what about splinter groups, without which<n>	#journal#	journal_VOL23_2.txt
a 32.5 foot crest, but put it back another day, to<n>Thursday.  It just kept coming at us like a bouncing<n>ball.<n>	#journal#	journal_VOL23_2.txt
hope had been to publish Volume IV in 2001, with<n>Volume V coming out in 2006.  That schedule, however,<n>was contingent on our maintaining our earlier level<n>	#journal#	journal_VOL23_4.txt
in) and we have a waiting list of 60 children who are hoping to come if a<n>spot should open. Many more camper referrals are coming from new<n>organizations such as school social-workers and family counseling<n>	#letters#	letters_114CUL059.txt
YMCA programs has helped them stay out of trouble. 65% of participants<n>will indicate that since they have been coming to the YMCA, caring about<n>other people has become more important to them.<n>	#letters#	letters_119CWL047.txt
strangers - Wanda chose to take on the responsibility of raising them<n>herself, knowing full well that the likelihood of her sister coming back<n>into the picture as a fulltime mother was not a strong one, at all.<n>	#letters#	letters_402CWL184.txt
Medical Internships, in 1999 the Center welcomed over 100 guests to<n>central Indiana. Visitors coming from South Africa, northern and west<n>Africa, China, Belgium, France, and Great Britain spent from two days to<n>	#letters#	letters_406CUL238.txt
services.<n>We look forward to seeing you in the coming year at the International<n>Citizen of the Year dinner, September 26 and at the International<n>	#letters#	letters_406CUL293.txt
students, they develop skills and perspectives that will help them meet<n>the complex challenges that face our society in the coming years.<n>Despite our efforts at innovation and efficiency, however, the cost of<n>	#letters#	letters_514C-L132.txt
Scholarships were enhanced or established. The new library received a<n>significant vote of pride and partnership, with contributions coming from<n>all areas of the campus. Many offices were able to create special staff<n>	#letters#	letters_516CZL212.txt
have witnessed many changes --physical location of the law school, new<n>faculty coming on board, faculty retiring, tax students surviving my<n>classes, and a periodic changing of the deans.<n>	#letters#	letters_530C-L219.txt
They said they both felt they knew me like an old friend because they'd<n>been coming to see IRT shows since their high school days. In fact, even<n>though they had gone to separate schools, each one's first experience<n>	#letters#	letters_609CWL257.txt
year, between 45,000 and 50,000 students from over 800 schools in 60<n>Indiana counties culminate their lessons on a variety of topics by coming<n>to the IRT to see a play.<n>	#letters#	letters_609CWL257.txt
Inauguration.<n>This coming January, you will take part in all the glitter and glamour<n>of the official Presidential Inaugural, including the swearing in<n>	#letters#	letters_714C-L270.txt
