All three would look at their shoes (one pair of Pradas, two pairs of<n>canvas sneakers) as Mobe 68 walks away.<n>"Well, that wasn't a bit awkward. So Bill, how funny to see you here.<n>	#fiction#	fiction_TheStory.txt
At the third floor, an emaciated woman could get on carrying a Maltese<n>with rheumy eyes and a bad underbite, as Joseph walks off, saying.<n>"Well, here's my floor. Nice to meet you, Mobe 68, but be cool--the past<n>	#fiction#	fiction_TheStory.txt
Party Out of Bounds<n>As Tim walks in between sheets of black plastic, Marcel is yelling<n>"Attention!" at the two jarheaded men from the HumVees.<n>	#fiction#	fiction_TheStory.txt
for a woman to come along to check the Dames. When no one goes in or<n>out, he pushes the door open and walks in, bending to look in the<n>stalls. There! A pair of jeans pulled down over fancy Pumas. It's her!<n>	#fiction#	fiction_TheStory.txt
for the sake of it. I try to provoke him a bit more.<n>"Sort of walks a fine line between religious and<n>sacrilegious, wouldn't you say?"<n>	#journal#	journal_Article247_3405.txt
stepping down in April, gave no real reason for his retirement , though<n>he must be tempted to scream, 'It was those damn Belgians!' as he walks out the<n>door."<n>	#journal#	journal_Article247_4154.txt
devouring the latest Michael Crichton, the cover carefully hidden from sight.<n>Suddenly, from nowhere, in walks Diana Trilling. "Ah, the son of Daniel Bell<n>and Pearl Kazin," she says, her great eyes shining sternly. "What are you<n>	#journal#	journal_Article247_4169.txt
Your take on Andy Kaufman sounds right. I remember thinking watching him<n>that he's either an incredible operator who walks off the set, after some<n>bizarre wrestling sketch, and shouts, "Who do I have to fuck to get a donut<n>	#journal#	journal_Article247_4318.txt
designing a successful shopping mall is to include lots of angles, so that you<n>can't see clearly from one end of it to another--that way, the customer walks<n>and walks, always convinced that the store he's trying to find is just around<n>	#journal#	journal_Article247_4427.txt
hitting the jumper to win Game 6 and the NBA championship in 1998.<n>He nails the shot. He wins the title. He walks away. Perfect. (Better than<n>Ted Williams even.)<n>	#journal#	journal_Article247_4471.txt
The Truman Show is a more effective movie with Carrey in it, because the<n>audience walks into the theatre caring more about Carrey than about Bridges.<n>And therefore, walks into the theatre, period. More people seem to have checked<n>	#journal#	journal_Article247_891.txt
audience walks into the theatre caring more about Carrey than about Bridges.<n>And therefore, walks into the theatre, period. More people seem to have checked<n>out Friday's performances of The Truman Show than attended the entire<n>	#journal#	journal_Article247_891.txt
series of quick cuts give this spot some depth and visual interest.<n>As Rodriguez walks down the<n>hall, he is identified first by name, then as the person who "led the fight to<n>	#journal#	journal_ArticleIP_1604.txt
Australia, has published a very long feature called "Another Year Down the<n>Drain." This is largely devoted to the failures of Australians in all walks of<n>life, but it also mentions Barbra Streisand's new, hugely publicized<n>	#journal#	journal_ArticleIP_1704.txt
silence when she opens the door. (It is during this quiet that I hear her two<n>questions.) The silence continues for 30 seconds till she walks around the<n>corner and disappears into a closed back corridor, followed by her legal team.<n>	#journal#	journal_ArticleIP_1799.txt
unabated. Indeed, it has probably increased due both to cultural<n>contagion--this is the Age of Celebrity in all walks of life--and to the<n>heightened competition among universities for increasingly footloose donor<n>	#journal#	journal_ArticleIP_1932.txt
editorial Friday that the affair had shown "the narrow and very<n>dangerous line that Israel walks in its ties with Turkey." It said there was<n>"no doubt that the military alliance with Turkey is one of the most important<n>	#journal#	journal_ArticleIP_20316.txt
commercial music. This seems to be a time-honored argument leveled at women<n>from all walks of life. It seems that if a woman shows any duality in her<n>opinions and/or her career endeavors, she is either confused about what she<n>	#journal#	journal_ArticleIP_21647.txt
Cryer. Pretty in Pink is tragically marred by the wrong ending: Ringwald<n>walks into the sunset with the preppie rich kid. But Hughes must have realized<n>his mistake, because the next year he essentially rewrote it as Some Kind of<n>	#journal#	journal_ArticleIP_21663.txt
days, feet do get their due. Ask any girl: Shoes matter as much as hairstyle in<n>all walks of life, and infinitely more than gloves and hats, despite being so<n>near the ground. Buying shoes demands sizable chunks of time and money, and the<n>	#journal#	journal_ArticleIP_21910.txt
Will asks the boy's name. "John Webster," he replies. There is a beat, as if to<n>cue audience laughter, and then Shakespeare walks away. The scene, which serves<n>no purpose in the film's plot (though Webster will later be instrumental in<n>	#journal#	journal_ArticleIP_22071.txt
Presidents Reagan and Bush--demolished Aldrich's claims. Clinton couldn't give<n>his Secret Service agents the slip (they shadow him when he walks around the<n>White House), couldn't arrange a private visit without tipping off hotel staff,<n>	#journal#	journal_ArticleIP_2370.txt
proud, history. In the latter category, the practice probably reached its nadir<n>with headshrinking. Sledzik walks across the storage room and fetches another<n>rare museum piece: a perfectly preserved head no larger than a tennis ball.<n>	#journal#	journal_ArticleIP_2442.txt
moment, then throws them to the floor with a shriek. She goes to the bar, puts<n>three ice cubes in a glass, pours a drink, lights a cigarette. She walks to the<n>window and pulls back the drawn curtain to peek out. The door opens, and<n>	#journal#	journal_ArticleIP_2496.txt
ML: No foreign?<n>Look, if you think I'm going to sit here while Kathleen f**king Willey walks<n>off with this scandal, you're mistaken. I made this thing. I wiggled my<n>	#journal#	journal_ArticleIP_2496.txt
The<n>stories are set in different walks of life--a TV studio, a rodeo, a bank, an<n>advertising agency, a toy factory--and each one seems to reflect the setting<n>	#journal#	journal_ArticleIP_2558.txt
the elite academies with taxpayer-supported "common schools," which admitted<n>young students from all walks of life. (Later, attendance become compulsory.)<n>In the Gilded Age, as immigrants and migrants flooded the cities, public<n>	#journal#	journal_ArticleIP_27715.txt
Thing He Wanted , is about--what else?--a woman adrift in history, her own<n>and America's. Elena McMahon, given to "fast walks and clean starts," fits the<n>mold of her predecessors, sensitive yet impassive females proficient at<n>	#journal#	journal_ArticleIP_2944.txt
"capacity for passive detachment." In fact, on the day when the action of the<n>novel begins, she walks off the campaign, without a clue as to what she plans<n>to do next.<n>	#journal#	journal_ArticleIP_2944.txt
crew of five Americans, a Canadian, and a Russian will transfer those supplies<n>to the Russian-American space station, in one of the 160 space walks on 86<n>flights needed to complete the station--and no doubt worth every penny.<n>	#journal#	journal_ArticleIP_29478.txt
wakes up to find that his girlfriend, a petite blonde, has turned into a beast<n>that walks on its knuckles. Worse, Simon's concern at this turn of events is<n>interpreted as insanity. He's hospitalized by chimp paramedics, and held for<n>	#journal#	journal_ArticleIP_3008.txt
of Horwitz's book lies in his gift for fleshing them out through precisely<n>rendered encounters with Southerners of all walks and all colors, united only<n>by the common Southern compulsion to answer a question with a story. Such<n>	#journal#	journal_ArticleIP_3059.txt
in front of the other, haunches delicately swaying, tail holding its curve,<n>peerless coat glittering in the sun. Our guide said that only the leopard walks<n>like that--the lions just shamble and clump along. Of course we deeply loved<n>	#journal#	journal_ArticleIP_3102.txt
motivational speakers, newscasters, and sportswriters. A person who talks<n>the talk and walks the walk is one who acts naturally and stylishly, whose<n>words and behavior are of a piece; a person who talks the talk without<n>	#journal#	journal_ArticleIP_3182.txt
property. They refrain from defacing Mercedes or Lexuses, these being objects<n>of envy, not resentment. Donald Trump walks the streets unafraid that someone<n>will scrawl some harsh architectural criticism across his vast backside. Even<n>	#journal#	journal_ArticleIP_32553.txt
Anything to keep from turning into one of those people.<n>The Slums of Beverly Hills also walks a line between two<n>genres, in this case coming-of-age sex comedy and autobiographical monologue.<n>	#journal#	journal_ArticleIP_3262.txt
yet not flatly derivative of, an Asian rice dish, a Capri bowl confidently<n>walks that fine line between elegance and edge--and was on sale last weekend<n>for $4.99.<n>	#journal#	journal_ArticleIP_3482.txt
Denominator<n>A demigod walks (or rides around in a limo) among<n>us, and his name is Jack Welch.<n>	#journal#	journal_ArticleIP_35569.txt
friends." Soon, Starling was conscripted into following the couple on their<n>walks through Washington's Rock Creek Park (for more details, click ) and<n>fending off reporters. Though Wilson was unmarried, dating another woman so<n>	#journal#	journal_ArticleIP_3595.txt
Chuck Palahniuk (the surname sounds like Eskimo for "palooka"--which somehow<n>fits), walks a line between the straight and ironic--it isn't always clear if<n>its glib sociological pronouncements are meant to be taken straight or as the<n>	#journal#	journal_ArticleIP_36643.txt
didn't really feel bad for saying what he said. In fact, he was more convinced<n>than ever that the Antichrist is a Jew who walks among us.<n>Let me pause for a moment to give three concise reasons why<n>	#journal#	journal_ArticleIP_45483.txt
reading them to reporters and faxing them to conservative talk shows. The GOP's<n>favorite quote from Wolf is, "I want to explore the shadow slut who walks<n>alongside us as we grow up, sometimes jeopardizing us and sometimes presenting<n>	#journal#	journal_ArticleIP_45523.txt
white on ash, gray on dusty brown, ebony on bone--the better to set off the<n>lurid splashes of crimson. Ichabod Crane walks through small doorways into<n>dark-toned rooms where pasty old men in white wigs stare at him balefully and<n>	#journal#	journal_ArticleIP_56271.txt
whose teen-age son is suddenly killed makes a pilgrimage to track down the<n>boy's father and in the process encounters women from all walks of<n>life--transsexuals, pregnant nuns, divas, and more. Spain's most famous<n>	#journal#	journal_ArticleIP_56519.txt
The Enquirer is now filled with headlines such as "Cat's Incredible:<n>Kitty walks 2000 miles back home" and "Millionaire Businessman Learns to Read<n>at 56!" The Enquirer has also taken to running "Helpful Household Hints"<n>	#journal#	journal_ArticleIP_67969.txt
By<n>saying no, Gore avoids this trap. Bradley, however, walks into it. He faults<n>Gore for suggesting "that I was going to hurt African-Americans [and] Latinos<n>	#journal#	journal_ArticleIP_68349.txt
be shorn--images of her girlhood flashing by as her locks rain down--and then<n>walks weightily to her throne, now a chalk-faced gorgon.<n>With all<n>	#journal#	journal_ArticleIP_8112.txt
dear--there's something saturnine in that face. As his Ed Norton-ish sidekick,<n>Kelly walks off--or, rather, rides off--with the picture, his skeletal frame<n>planted buck naked on a motorcycle as he rushes to reach Devine's house before<n>	#journal#	journal_ArticleIP_8700.txt
cheapest ground cold cuts to cheap talk, and the<n>same steps takes up from tripe, the walks of the first<n>and second stomachs of ruminants,' to `worthless,<n>	#journal#	journal_VOL16_3.txt
a monopoly on Niceness.  The Japanese proverb<n>“Inu ga arukeba, bo ni ataru” `A dog that walks<n>around will find a stick' illustrates this nicely.  Modern<n>	#journal#	journal_VOL17_4.txt
American toponymy is carried on by people<n>of all academic disciplines, and from many walks of<n>life.  With academia's standard rewards of promotion<n>	#journal#	journal_VOL18_2.txt
contrèpeterie .<n>For the French, in all walks of life, to render<n>one sound for another is not a slip but an art, practised<n>	#journal#	journal_VOL19_2.txt
sense, timing is extremely important.  We know that<n>if any joke begins with A guy walks into a bar with<n>an iguana on a leash, sits down, and orders a zombie<n>	#journal#	journal_VOL21_4.txt
corners of the country and from vastly different<n>walks of life are hurled together under extreme, often<n>bitter conditions.  In the case of Serbian, language<n>	#journal#	journal_VOL22_1.txt
restaurant...<n>A girl on the near northwest side walks past a community garden and<n>playground today, where not long ago a vacant lot sat littered and<n>	#letters#	letters_301CUL075.txt
Indianapolis, Indiana of our diverse tradition of giving, caring and<n>serving, carried out every day by Americans from all walks of life, is<n>key to the present and future vitality of our nation.<n>	#letters#	letters_531C-L245.txt
